Luci,TotalCyc,GuCyc,FenCyc,StartTime,FenStartTime,FenEndTime,rawLuci
1,72,57,15,2018/11/6 0:34,2018/11/6 1:31,2018/11/6 1:45,2
2,56,41,15,2018/11/6 1:46,2018/11/6 2:27,2018/11/6 2:41,3
3,67,52,15,2018/11/6 2:42,2018/11/6 3:34,2018/11/6 3:48,4
4,59,45,14,2018/11/6 3:49,2018/11/6 4:34,2018/11/6 4:47,5
5,58,45,13,2018/11/6 4:48,2018/11/6 5:33,2018/11/6 5:45,6
6,38,34,4,2018/11/6 5:46,2018/11/6 6:20,2018/11/6 6:23,7
7,11,3,8,2018/11/6 6:24,2018/11/6 6:27,2018/11/6 6:34,8
8,65,51,14,2018/11/6 6:35,2018/11/6 7:26,2018/11/6 7:39,9
9,52,38,14,2018/11/6 7:40,2018/11/6 8:18,2018/11/6 8:31,10
10,53,38,15,2018/11/6 8:32,2018/11/6 9:10,2018/11/6 9:24,11
11,66,50,16,2018/11/6 9:25,2018/11/6 10:15,2018/11/6 10:30,12
12,44,35,9,2018/11/6 10:31,2018/11/6 11:06,2018/11/6 11:14,13
13,8,3,5,2018/11/6 11:15,2018/11/6 11:18,2018/11/6 11:22,14
14,35,31,4,2018/11/6 11:23,2018/11/6 11:54,2018/11/6 11:57,15
15,4,1,3,2018/11/6 11:58,2018/11/6 11:59,2018/11/6 12:01,16
16,67,52,15,2018/11/6 12:02,2018/11/6 12:54,2018/11/6 13:08,17
17,53,41,12,2018/11/6 13:09,2018/11/6 13:50,2018/11/6 14:01,18
18,38,34,4,2018/11/6 14:02,2018/11/6 14:36,2018/11/6 14:39,19
19,5,1,4,2018/11/6 14:40,2018/11/6 14:41,2018/11/6 14:44,20
20,6,3,3,2018/11/6 14:45,2018/11/6 14:48,2018/11/6 14:50,21
21,56,40,16,2018/11/6 14:51,2018/11/6 15:31,2018/11/6 15:46,22
22,56,41,15,2018/11/6 15:47,2018/11/6 16:28,2018/11/6 16:42,23
23,52,36,16,2018/11/6 16:43,2018/11/6 17:19,2018/11/6 17:34,24
24,67,52,15,2018/11/6 17:35,2018/11/6 18:27,2018/11/6 18:41,25
25,73,59,14,2018/11/6 18:42,2018/11/6 19:41,2018/11/6 19:54,26
26,58,44,14,2018/11/6 19:55,2018/11/6 20:39,2018/11/6 20:52,27
27,61,45,16,2018/11/6 20:53,2018/11/6 21:38,2018/11/6 21:53,28
28,45,30,15,2018/11/6 21:54,2018/11/6 22:24,2018/11/6 22:38,29
29,54,39,15,2018/11/6 22:39,2018/11/6 23:18,2018/11/6 23:32,30
30,60,45,15,2018/11/6 23:33,2018/11/7 0:18,2018/11/7 0:32,31
31,54,39,15,2018/11/7 0:33,2018/11/7 1:12,2018/11/7 1:26,32
32,84,69,15,2018/11/7 1:27,2018/11/7 2:36,2018/11/7 2:50,33
33,52,38,14,2018/11/7 2:51,2018/11/7 3:29,2018/11/7 3:42,34
34,45,31,14,2018/11/7 3:43,2018/11/7 4:14,2018/11/7 4:27,35
35,77,62,15,2018/11/7 4:28,2018/11/7 5:30,2018/11/7 5:44,36
36,81,67,14,2018/11/7 5:45,2018/11/7 6:52,2018/11/7 7:05,37
37,52,36,16,2018/11/7 7:06,2018/11/7 7:42,2018/11/7 7:57,38
38,94,77,17,2018/11/7 7:58,2018/11/7 9:15,2018/11/7 9:31,39
39,72,70,2,2018/11/7 9:32,2018/11/7 10:42,2018/11/7 10:43,40
40,21,7,14,2018/11/7 10:44,2018/11/7 10:51,2018/11/7 11:04,41
41,51,44,7,2018/11/7 11:05,2018/11/7 11:49,2018/11/7 11:55,42
42,52,37,15,2018/11/7 12:06,2018/11/7 12:43,2018/11/7 12:57,43
43,60,45,15,2018/11/7 12:58,2018/11/7 13:43,2018/11/7 13:57,44
44,51,35,16,2018/11/7 13:58,2018/11/7 14:33,2018/11/7 14:48,45
45,47,33,14,2018/11/7 14:49,2018/11/7 15:22,2018/11/7 15:35,46
46,67,65,2,2018/11/7 15:36,2018/11/7 16:41,2018/11/7 16:42,47
47,15,5,10,2018/11/7 16:43,2018/11/7 16:48,2018/11/7 16:57,48
48,59,44,15,2018/11/7 16:58,2018/11/7 17:42,2018/11/7 17:56,49
49,46,45,1,2018/11/7 17:57,2018/11/7 18:42,2018/11/7 18:42,50
50,14,1,13,2018/11/7 18:43,2018/11/7 18:44,2018/11/7 18:56,51
51,58,44,14,2018/11/7 18:57,2018/11/7 19:41,2018/11/7 19:54,52
52,63,49,14,2018/11/7 19:55,2018/11/7 20:44,2018/11/7 20:57,53
53,60,46,14,2018/11/7 20:58,2018/11/7 21:44,2018/11/7 21:57,54
54,60,46,14,2018/11/7 21:58,2018/11/7 22:44,2018/11/7 22:57,55
55,48,34,14,2018/11/7 22:58,2018/11/7 23:32,2018/11/7 23:45,56
56,43,28,15,2018/11/7 23:46,2018/11/8 0:14,2018/11/8 0:28,57
57,42,28,14,2018/11/8 0:29,2018/11/8 0:57,2018/11/8 1:10,58
58,87,73,14,2018/11/8 1:11,2018/11/8 2:24,2018/11/8 2:37,59
59,57,42,15,2018/11/8 2:38,2018/11/8 3:20,2018/11/8 3:34,60
60,66,50,16,2018/11/8 3:35,2018/11/8 4:25,2018/11/8 4:40,61
61,47,33,14,2018/11/8 4:41,2018/11/8 5:14,2018/11/8 5:27,62
62,43,29,14,2018/11/8 5:28,2018/11/8 5:57,2018/11/8 6:10,63
63,44,31,13,2018/11/8 6:11,2018/11/8 6:42,2018/11/8 6:54,64
64,105,92,13,2018/11/8 6:55,2018/11/8 8:27,2018/11/8 8:39,65
65,79,67,12,2018/11/8 8:40,2018/11/8 9:47,2018/11/8 9:58,66
66,57,42,15,2018/11/8 9:59,2018/11/8 10:41,2018/11/8 10:55,67
67,60,47,13,2018/11/8 10:56,2018/11/8 11:43,2018/11/8 11:55,68
68,62,49,13,2018/11/8 11:56,2018/11/8 12:45,2018/11/8 12:57,69
69,64,52,12,2018/11/8 12:58,2018/11/8 13:50,2018/11/8 14:01,70
70,104,90,14,2018/11/8 14:02,2018/11/8 15:32,2018/11/8 15:45,71
71,73,58,15,2018/11/8 15:46,2018/11/8 16:44,2018/11/8 16:58,72
72,80,65,15,2018/11/8 16:59,2018/11/8 18:04,2018/11/8 18:18,73
73,77,63,14,2018/11/8 18:19,2018/11/8 19:22,2018/11/8 19:35,74
74,54,40,14,2018/11/8 19:36,2018/11/8 20:16,2018/11/8 20:29,75
75,73,59,14,2018/11/8 20:30,2018/11/8 21:29,2018/11/8 21:42,76
76,54,38,16,2018/11/8 21:43,2018/11/8 22:21,2018/11/8 22:36,77
77,47,32,15,2018/11/8 22:37,2018/11/8 23:09,2018/11/8 23:23,78
78,56,38,18,2018/11/8 23:24,2018/11/9 0:02,2018/11/9 0:19,79
79,181,166,15,2018/11/9 0:20,2018/11/9 3:06,2018/11/9 3:20,80
80,59,45,14,2018/11/9 3:21,2018/11/9 4:06,2018/11/9 4:19,81
81,51,35,16,2018/11/9 4:20,2018/11/9 4:55,2018/11/9 5:10,82
82,74,57,17,2018/11/9 5:11,2018/11/9 6:08,2018/11/9 6:24,83
83,52,36,16,2018/11/9 6:25,2018/11/9 7:01,2018/11/9 7:16,84
84,42,28,14,2018/11/9 7:17,2018/11/9 7:45,2018/11/9 7:58,85
85,75,61,14,2018/11/9 7:59,2018/11/9 9:00,2018/11/9 9:13,86
86,55,54,1,2018/11/9 9:14,2018/11/9 10:08,2018/11/9 10:08,87
87,16,1,15,2018/11/9 10:09,2018/11/9 10:10,2018/11/9 10:24,88
88,54,38,16,2018/11/9 10:25,2018/11/9 11:03,2018/11/9 11:18,89
89,85,69,16,2018/11/9 11:19,2018/11/9 12:28,2018/11/9 12:43,90
90,48,34,14,2018/11/9 12:44,2018/11/9 13:18,2018/11/9 13:31,91
91,46,30,16,2018/11/9 13:32,2018/11/9 14:02,2018/11/9 14:17,92
92,57,42,15,2018/11/9 14:18,2018/11/9 15:00,2018/11/9 15:14,93
93,78,62,16,2018/11/9 15:15,2018/11/9 16:17,2018/11/9 16:32,94
94,58,42,16,2018/11/9 16:33,2018/11/9 17:15,2018/11/9 17:30,95
95,80,63,17,2018/11/9 17:31,2018/11/9 18:34,2018/11/9 18:50,96
96,66,51,15,2018/11/9 18:51,2018/11/9 19:42,2018/11/9 19:56,97
97,56,41,15,2018/11/9 19:57,2018/11/9 20:38,2018/11/9 20:52,98
98,64,49,15,2018/11/9 20:53,2018/11/9 21:42,2018/11/9 21:56,99
99,57,41,16,2018/11/9 21:57,2018/11/9 22:38,2018/11/9 22:53,100
100,51,34,17,2018/11/9 22:54,2018/11/9 23:28,2018/11/9 23:44,101
101,50,33,17,2018/11/9 23:45,2018/11/10 0:18,2018/11/10 0:34,102
102,53,38,15,2018/11/10 0:35,2018/11/10 1:13,2018/11/10 1:27,103
103,87,74,13,2018/11/10 1:28,2018/11/10 2:42,2018/11/10 2:54,104
104,53,40,13,2018/11/10 2:55,2018/11/10 3:35,2018/11/10 3:47,105
105,65,58,7,2018/11/10 3:48,2018/11/10 4:46,2018/11/10 4:52,106
106,74,60,14,2018/11/10 4:53,2018/11/10 5:53,2018/11/10 6:06,107
107,37,34,3,2018/11/10 6:07,2018/11/10 6:41,2018/11/10 6:43,108
108,20,10,10,2018/11/10 6:44,2018/11/10 6:54,2018/11/10 7:03,109
109,51,38,13,2018/11/10 7:04,2018/11/10 7:42,2018/11/10 7:54,110
110,53,41,12,2018/11/10 7:55,2018/11/10 8:36,2018/11/10 8:47,111
111,77,62,15,2018/11/10 8:48,2018/11/10 9:50,2018/11/10 10:04,112
112,61,45,16,2018/11/10 10:05,2018/11/10 10:50,2018/11/10 11:05,113
113,83,67,16,2018/11/10 11:06,2018/11/10 12:13,2018/11/10 12:28,114
114,47,31,16,2018/11/10 12:29,2018/11/10 13:00,2018/11/10 13:15,115
115,46,30,16,2018/11/10 13:16,2018/11/10 13:46,2018/11/10 14:01,116
116,59,44,15,2018/11/10 14:02,2018/11/10 14:46,2018/11/10 15:00,117
117,51,36,15,2018/11/10 15:01,2018/11/10 15:37,2018/11/10 15:51,118
118,47,32,15,2018/11/10 15:52,2018/11/10 16:24,2018/11/10 16:38,119
119,61,44,17,2018/11/10 16:39,2018/11/10 17:23,2018/11/10 17:39,120
120,51,35,16,2018/11/10 17:40,2018/11/10 18:15,2018/11/10 18:30,121
121,43,28,15,2018/11/10 18:31,2018/11/10 18:59,2018/11/10 19:13,122
122,45,30,15,2018/11/10 19:14,2018/11/10 19:44,2018/11/10 19:58,123
123,64,46,18,2018/11/10 19:59,2018/11/10 20:45,2018/11/10 21:02,124
124,46,30,16,2018/11/10 21:03,2018/11/10 21:33,2018/11/10 21:48,125
125,50,33,17,2018/11/10 21:49,2018/11/10 22:22,2018/11/10 22:38,126
126,52,36,16,2018/11/10 22:39,2018/11/10 23:15,2018/11/10 23:30,127
127,71,54,17,2018/11/10 23:31,2018/11/11 0:25,2018/11/11 0:41,128
128,46,31,15,2018/11/11 0:42,2018/11/11 1:13,2018/11/11 1:27,129
129,49,33,16,2018/11/11 1:28,2018/11/11 2:01,2018/11/11 2:16,130
130,62,46,16,2018/11/11 2:17,2018/11/11 3:03,2018/11/11 3:18,131
131,49,33,16,2018/11/11 3:19,2018/11/11 3:52,2018/11/11 4:07,132
132,67,51,16,2018/11/11 4:08,2018/11/11 4:59,2018/11/11 5:14,133
133,66,50,16,2018/11/11 5:15,2018/11/11 6:05,2018/11/11 6:20,134
134,47,31,16,2018/11/11 6:21,2018/11/11 6:52,2018/11/11 7:07,135
135,49,34,15,2018/11/11 7:08,2018/11/11 7:42,2018/11/11 7:56,136
136,52,39,13,2018/11/11 7:57,2018/11/11 8:36,2018/11/11 8:48,137
137,62,49,13,2018/11/11 8:49,2018/11/11 9:38,2018/11/11 9:50,138
138,48,34,14,2018/11/11 9:51,2018/11/11 10:25,2018/11/11 10:38,139
139,69,56,13,2018/11/11 10:39,2018/11/11 11:35,2018/11/11 11:47,140
140,122,107,15,2018/11/11 11:48,2018/11/11 13:35,2018/11/11 13:49,141
141,50,36,14,2018/11/11 13:50,2018/11/11 14:26,2018/11/11 14:39,142
142,52,38,14,2018/11/11 14:40,2018/11/11 15:18,2018/11/11 15:31,143
143,43,27,16,2018/11/11 15:32,2018/11/11 15:59,2018/11/11 16:14,144
144,84,69,15,2018/11/11 16:15,2018/11/11 17:24,2018/11/11 17:38,145
145,58,40,18,2018/11/11 17:39,2018/11/11 18:19,2018/11/11 18:36,146
146,41,26,15,2018/11/11 18:37,2018/11/11 19:03,2018/11/11 19:17,147
147,40,27,13,2018/11/11 19:18,2018/11/11 19:45,2018/11/11 19:57,148
148,80,65,15,2018/11/11 19:58,2018/11/11 21:03,2018/11/11 21:17,149
149,64,49,15,2018/11/11 21:18,2018/11/11 22:07,2018/11/11 22:21,150
150,53,37,16,2018/11/11 22:22,2018/11/11 22:59,2018/11/11 23:14,151
151,49,34,15,2018/11/11 23:15,2018/11/11 23:49,2018/11/12 0:03,152
152,46,31,15,2018/11/12 0:04,2018/11/12 0:35,2018/11/12 0:49,153
153,57,42,15,2018/11/12 0:50,2018/11/12 1:32,2018/11/12 1:46,154
154,57,42,15,2018/11/12 1:47,2018/11/12 2:29,2018/11/12 2:43,155
155,60,45,15,2018/11/12 2:44,2018/11/12 3:29,2018/11/12 3:43,156
156,67,53,14,2018/11/12 3:44,2018/11/12 4:37,2018/11/12 4:50,157
157,54,39,15,2018/11/12 4:51,2018/11/12 5:30,2018/11/12 5:44,158
158,58,43,15,2018/11/12 5:45,2018/11/12 6:28,2018/11/12 6:42,159
159,63,48,15,2018/11/12 6:43,2018/11/12 7:31,2018/11/12 7:45,160
160,57,43,14,2018/11/12 7:46,2018/11/12 8:29,2018/11/12 8:42,161
161,63,48,15,2018/11/12 8:43,2018/11/12 9:31,2018/11/12 9:45,162
162,53,39,14,2018/11/12 9:46,2018/11/12 10:25,2018/11/12 10:38,163
163,59,57,2,2018/11/12 10:39,2018/11/12 11:36,2018/11/12 11:37,164
164,13,2,11,2018/11/12 11:38,2018/11/12 11:40,2018/11/12 11:50,165
165,53,39,14,2018/11/12 11:51,2018/11/12 12:30,2018/11/12 12:43,166
166,51,38,13,2018/11/12 12:44,2018/11/12 13:22,2018/11/12 13:34,167
167,52,37,15,2018/11/12 13:35,2018/11/12 14:12,2018/11/12 14:26,168
168,45,31,14,2018/11/12 14:27,2018/11/12 14:58,2018/11/12 15:11,169
169,49,34,15,2018/11/12 15:12,2018/11/12 15:46,2018/11/12 16:00,170
170,99,84,15,2018/11/12 16:01,2018/11/12 17:25,2018/11/12 17:39,171
171,87,73,14,2018/11/12 17:40,2018/11/12 18:53,2018/11/12 19:06,172
172,49,34,15,2018/11/12 19:07,2018/11/12 19:41,2018/11/12 19:55,173
173,58,44,14,2018/11/12 19:56,2018/11/12 20:40,2018/11/12 20:53,174
174,51,37,14,2018/11/12 20:54,2018/11/12 21:31,2018/11/12 21:44,175
175,46,30,16,2018/11/12 21:45,2018/11/12 22:15,2018/11/12 22:30,176
176,69,52,17,2018/11/12 22:31,2018/11/12 23:23,2018/11/12 23:39,177
177,63,48,15,2018/11/12 23:40,2018/11/13 0:28,2018/11/13 0:42,178
178,51,36,15,2018/11/13 0:43,2018/11/13 1:19,2018/11/13 1:33,179
179,69,53,16,2018/11/13 1:34,2018/11/13 2:27,2018/11/13 2:42,180
180,48,34,14,2018/11/13 2:43,2018/11/13 3:17,2018/11/13 3:30,181
181,86,71,15,2018/11/13 3:31,2018/11/13 4:42,2018/11/13 4:56,182
182,55,38,17,2018/11/13 4:57,2018/11/13 5:35,2018/11/13 5:51,183
183,61,45,16,2018/11/13 5:52,2018/11/13 6:37,2018/11/13 6:52,184
184,45,30,15,2018/11/13 6:53,2018/11/13 7:23,2018/11/13 7:37,185
185,84,71,13,2018/11/13 7:38,2018/11/13 8:49,2018/11/13 9:01,186
186,539,525,14,2018/11/13 9:02,2018/11/13 17:47,2018/11/13 18:00,187
187,54,40,14,2018/11/13 18:01,2018/11/13 18:41,2018/11/13 18:54,188
188,55,40,15,2018/11/13 18:55,2018/11/13 19:35,2018/11/13 19:49,189
189,42,37,5,2018/11/13 19:50,2018/11/13 20:27,2018/11/13 20:31,190
190,13,3,10,2018/11/13 20:32,2018/11/13 20:35,2018/11/13 20:44,191
191,48,34,14,2018/11/13 20:45,2018/11/13 21:19,2018/11/13 21:32,192
192,48,30,18,2018/11/13 21:33,2018/11/13 22:03,2018/11/13 22:20,193
193,64,48,16,2018/11/13 22:21,2018/11/13 23:09,2018/11/13 23:24,194
194,49,31,18,2018/11/13 23:25,2018/11/13 23:56,2018/11/14 0:13,195
195,50,32,18,2018/11/14 0:14,2018/11/14 0:46,2018/11/14 1:03,196
196,52,50,2,2018/11/14 1:04,2018/11/14 1:54,2018/11/14 1:55,197
197,16,1,15,2018/11/14 1:56,2018/11/14 1:57,2018/11/14 2:11,198
198,58,53,5,2018/11/14 2:12,2018/11/14 3:05,2018/11/14 3:09,199
199,14,2,12,2018/11/14 3:10,2018/11/14 3:12,2018/11/14 3:23,200
200,53,36,17,2018/11/14 3:24,2018/11/14 4:00,2018/11/14 4:16,201
201,48,32,16,2018/11/14 4:17,2018/11/14 4:49,2018/11/14 5:04,202
202,55,39,16,2018/11/14 5:05,2018/11/14 5:44,2018/11/14 5:59,203
203,61,48,13,2018/11/14 6:00,2018/11/14 6:48,2018/11/14 7:00,204
204,57,44,13,2018/11/14 7:01,2018/11/14 7:45,2018/11/14 7:57,205
205,58,46,12,2018/11/14 7:58,2018/11/14 8:44,2018/11/14 8:55,206
206,51,39,12,2018/11/14 8:56,2018/11/14 9:35,2018/11/14 9:46,207
207,48,40,8,2018/11/14 9:47,2018/11/14 10:27,2018/11/14 10:34,208
208,96,83,13,2018/11/14 10:35,2018/11/14 11:58,2018/11/14 12:10,209
209,55,42,13,2018/11/14 12:11,2018/11/14 12:53,2018/11/14 13:05,210
210,62,47,15,2018/11/14 13:06,2018/11/14 13:53,2018/11/14 14:07,211
211,57,42,15,2018/11/14 14:08,2018/11/14 14:50,2018/11/14 15:04,212
212,54,40,14,2018/11/14 15:05,2018/11/14 15:45,2018/11/14 15:58,213
213,47,33,14,2018/11/14 15:59,2018/11/14 16:32,2018/11/14 16:45,214
214,55,42,13,2018/11/14 16:46,2018/11/14 17:28,2018/11/14 17:40,215
215,92,78,14,2018/11/14 17:41,2018/11/14 18:59,2018/11/14 19:12,216
216,45,30,15,2018/11/14 19:13,2018/11/14 19:43,2018/11/14 19:57,217
217,53,38,15,2018/11/14 19:58,2018/11/14 20:36,2018/11/14 20:50,218
218,36,33,3,2018/11/14 20:51,2018/11/14 21:24,2018/11/14 21:26,219
219,12,3,9,2018/11/14 21:27,2018/11/14 21:30,2018/11/14 21:38,220
220,55,40,15,2018/11/14 21:39,2018/11/14 22:19,2018/11/14 22:33,221
221,53,38,15,2018/11/14 22:34,2018/11/14 23:12,2018/11/14 23:26,222
222,54,52,2,2018/11/14 23:27,2018/11/15 0:19,2018/11/15 0:20,223
223,18,7,11,2018/11/15 0:21,2018/11/15 0:28,2018/11/15 0:38,224
224,57,43,14,2018/11/15 0:39,2018/11/15 1:22,2018/11/15 1:35,225
225,54,40,14,2018/11/15 1:36,2018/11/15 2:16,2018/11/15 2:29,226
226,48,45,3,2018/11/15 2:30,2018/11/15 3:15,2018/11/15 3:17,227
227,20,7,13,2018/11/15 3:18,2018/11/15 3:25,2018/11/15 3:37,228
228,61,46,15,2018/11/15 3:38,2018/11/15 4:24,2018/11/15 4:38,229
229,50,36,14,2018/11/15 4:39,2018/11/15 5:15,2018/11/15 5:28,230
230,52,35,17,2018/11/15 5:29,2018/11/15 6:04,2018/11/15 6:20,231
231,95,79,16,2018/11/15 6:21,2018/11/15 7:40,2018/11/15 7:55,232
232,58,43,15,2018/11/15 7:56,2018/11/15 8:39,2018/11/15 8:53,233
233,55,53,2,2018/11/15 8:54,2018/11/15 9:47,2018/11/15 9:48,234
234,18,6,12,2018/11/15 9:49,2018/11/15 9:55,2018/11/15 10:06,235
235,169,156,13,2018/11/15 10:07,2018/11/15 12:43,2018/11/15 12:55,236
236,3,1,2,2018/11/15 12:56,2018/11/15 12:57,2018/11/15 12:58,237
237,167,152,15,2018/11/15 12:59,2018/11/15 15:31,2018/11/15 15:45,238
238,51,35,16,2018/11/15 15:46,2018/11/15 16:21,2018/11/15 16:36,239
239,50,35,15,2018/11/15 16:37,2018/11/15 17:12,2018/11/15 17:26,240
240,50,35,15,2018/11/15 17:27,2018/11/15 18:02,2018/11/15 18:16,241
241,51,36,15,2018/11/15 18:17,2018/11/15 18:53,2018/11/15 19:07,242
242,49,34,15,2018/11/15 19:08,2018/11/15 19:42,2018/11/15 19:56,243
243,51,47,4,2018/11/15 19:57,2018/11/15 20:44,2018/11/15 20:47,244
244,12,1,11,2018/11/15 20:48,2018/11/15 20:49,2018/11/15 20:59,245
245,44,36,8,2018/11/15 21:00,2018/11/15 21:36,2018/11/15 21:43,246
246,24,18,6,2018/11/15 21:44,2018/11/15 22:02,2018/11/15 22:07,247
247,70,54,16,2018/11/15 22:08,2018/11/15 23:02,2018/11/15 23:17,248
248,48,33,15,2018/11/15 23:18,2018/11/15 23:51,2018/11/16 0:05,249
249,51,35,16,2018/11/16 0:06,2018/11/16 0:41,2018/11/16 0:56,250
250,54,39,15,2018/11/16 0:57,2018/11/16 1:36,2018/11/16 1:50,251
251,41,31,10,2018/11/16 1:51,2018/11/16 2:22,2018/11/16 2:31,252
252,71,55,16,2018/11/16 2:32,2018/11/16 3:27,2018/11/16 3:42,253
253,51,35,16,2018/11/16 3:43,2018/11/16 4:18,2018/11/16 4:33,254
254,45,29,16,2018/11/16 4:34,2018/11/16 5:03,2018/11/16 5:18,255
255,46,31,15,2018/11/16 5:19,2018/11/16 5:50,2018/11/16 6:04,256
256,47,33,14,2018/11/16 6:05,2018/11/16 6:38,2018/11/16 6:51,257
257,46,31,15,2018/11/16 6:52,2018/11/16 7:23,2018/11/16 7:37,258
258,57,42,15,2018/11/16 7:38,2018/11/16 8:20,2018/11/16 8:34,259
259,63,49,14,2018/11/16 8:35,2018/11/16 9:24,2018/11/16 9:37,260
260,68,54,14,2018/11/16 9:38,2018/11/16 10:32,2018/11/16 10:45,261
261,50,49,1,2018/11/16 10:46,2018/11/16 11:35,2018/11/16 11:35,262
262,16,2,14,2018/11/16 11:36,2018/11/16 11:38,2018/11/16 11:51,263
263,48,35,13,2018/11/16 11:52,2018/11/16 12:27,2018/11/16 12:39,264
264,99,88,11,2018/11/16 12:40,2018/11/16 14:08,2018/11/16 14:18,265
265,48,34,14,2018/11/16 14:19,2018/11/16 14:53,2018/11/16 15:06,266
266,73,60,13,2018/11/16 15:07,2018/11/16 16:07,2018/11/16 16:19,267
267,56,42,14,2018/11/16 16:20,2018/11/16 17:02,2018/11/16 17:15,268
268,86,72,14,2018/11/16 17:16,2018/11/16 18:28,2018/11/16 18:41,269
269,44,42,2,2018/11/16 18:42,2018/11/16 19:24,2018/11/16 19:25,270
270,13,1,12,2018/11/16 19:26,2018/11/16 19:27,2018/11/16 19:38,271
271,62,49,13,2018/11/16 19:39,2018/11/16 20:28,2018/11/16 20:40,272
272,88,74,14,2018/11/16 20:41,2018/11/16 21:55,2018/11/16 22:08,273
273,48,34,14,2018/11/16 22:09,2018/11/16 22:43,2018/11/16 22:56,274
274,51,37,14,2018/11/16 22:57,2018/11/16 23:34,2018/11/16 23:47,275
275,75,61,14,2018/11/16 23:48,2018/11/17 0:49,2018/11/17 1:02,276
276,57,44,13,2018/11/17 1:03,2018/11/17 1:47,2018/11/17 1:59,277
277,55,41,14,2018/11/17 2:00,2018/11/17 2:41,2018/11/17 2:54,278
278,73,58,15,2018/11/17 2:55,2018/11/17 3:53,2018/11/17 4:07,279
279,57,42,15,2018/11/17 4:08,2018/11/17 4:50,2018/11/17 5:04,280
280,54,39,15,2018/11/17 5:05,2018/11/17 5:44,2018/11/17 5:58,281
281,63,48,15,2018/11/17 5:59,2018/11/17 6:47,2018/11/17 7:01,282
282,47,34,13,2018/11/17 7:02,2018/11/17 7:36,2018/11/17 7:48,283
283,52,37,15,2018/11/17 7:49,2018/11/17 8:26,2018/11/17 8:40,284
284,55,40,15,2018/11/17 8:41,2018/11/17 9:21,2018/11/17 9:35,285
285,51,38,13,2018/11/17 9:36,2018/11/17 10:14,2018/11/17 10:26,286
286,54,39,15,2018/11/17 10:27,2018/11/17 11:06,2018/11/17 11:20,287
287,62,47,15,2018/11/17 11:21,2018/11/17 12:08,2018/11/17 12:22,288
288,53,38,15,2018/11/17 12:23,2018/11/17 13:01,2018/11/17 13:15,289
289,50,38,12,2018/11/17 13:16,2018/11/17 13:54,2018/11/17 14:05,290
290,65,49,16,2018/11/17 14:06,2018/11/17 14:55,2018/11/17 15:10,291
291,57,42,15,2018/11/17 15:11,2018/11/17 15:53,2018/11/17 16:07,292
292,33,30,3,2018/11/17 16:08,2018/11/17 16:38,2018/11/17 16:40,293
293,4,1,3,2018/11/17 16:41,2018/11/17 16:42,2018/11/17 16:44,294
294,8,2,6,2018/11/17 16:45,2018/11/17 16:47,2018/11/17 16:52,295
295,46,39,7,2018/11/17 16:53,2018/11/17 17:32,2018/11/17 17:38,296
296,7,2,5,2018/11/17 17:39,2018/11/17 17:41,2018/11/17 17:45,297
297,71,56,15,2018/11/17 17:46,2018/11/17 18:42,2018/11/17 18:56,298
298,58,43,15,2018/11/17 18:57,2018/11/17 19:40,2018/11/17 19:54,299
299,54,41,13,2018/11/17 19:55,2018/11/17 20:36,2018/11/17 20:48,300
300,144,129,15,2018/11/17 20:49,2018/11/17 22:58,2018/11/17 23:12,301
301,63,47,16,2018/11/17 23:13,2018/11/18 0:00,2018/11/18 0:15,302
302,48,45,3,2018/11/18 0:16,2018/11/18 1:01,2018/11/18 1:03,303
303,15,4,11,2018/11/18 1:04,2018/11/18 1:08,2018/11/18 1:18,304
304,49,36,13,2018/11/18 1:19,2018/11/18 1:55,2018/11/18 2:07,305
305,47,32,15,2018/11/18 2:08,2018/11/18 2:40,2018/11/18 2:54,306
306,95,82,13,2018/11/18 2:55,2018/11/18 4:17,2018/11/18 4:29,307
307,47,34,13,2018/11/18 4:30,2018/11/18 5:04,2018/11/18 5:16,308
308,52,38,14,2018/11/18 5:17,2018/11/18 5:55,2018/11/18 6:08,309
309,73,58,15,2018/11/18 6:09,2018/11/18 7:07,2018/11/18 7:21,310
310,55,40,15,2018/11/18 7:22,2018/11/18 8:02,2018/11/18 8:16,311
311,50,34,16,2018/11/18 8:17,2018/11/18 8:51,2018/11/18 9:06,312
312,56,41,15,2018/11/18 9:07,2018/11/18 9:48,2018/11/18 10:02,313
313,105,91,14,2018/11/18 10:03,2018/11/18 11:34,2018/11/18 11:47,314
314,53,39,14,2018/11/18 11:48,2018/11/18 12:27,2018/11/18 12:40,315
315,47,32,15,2018/11/18 12:41,2018/11/18 13:13,2018/11/18 13:27,316
316,51,36,15,2018/11/18 13:28,2018/11/18 14:04,2018/11/18 14:18,317
317,53,38,15,2018/11/18 14:19,2018/11/18 14:57,2018/11/18 15:11,318
318,47,32,15,2018/11/18 15:12,2018/11/18 15:44,2018/11/18 15:58,319
319,67,52,15,2018/11/18 15:59,2018/11/18 16:51,2018/11/18 17:05,320
320,47,34,13,2018/11/18 17:06,2018/11/18 17:40,2018/11/18 17:52,321
321,52,38,14,2018/11/18 17:53,2018/11/18 18:31,2018/11/18 18:44,322
322,56,41,15,2018/11/18 18:45,2018/11/18 19:26,2018/11/18 19:40,323
323,58,43,15,2018/11/18 19:41,2018/11/18 20:24,2018/11/18 20:38,324
324,89,74,15,2018/11/18 20:39,2018/11/18 21:53,2018/11/18 22:07,325
325,75,59,16,2018/11/18 22:08,2018/11/18 23:07,2018/11/18 23:22,326
326,48,32,16,2018/11/18 23:23,2018/11/18 23:55,2018/11/19 0:10,327
327,74,59,15,2018/11/19 0:11,2018/11/19 1:10,2018/11/19 1:24,328
328,60,46,14,2018/11/19 1:25,2018/11/19 2:11,2018/11/19 2:24,329
329,77,73,4,2018/11/19 2:25,2018/11/19 3:38,2018/11/19 3:41,330
330,14,5,9,2018/11/19 3:42,2018/11/19 3:47,2018/11/19 3:55,331
331,46,30,16,2018/11/19 3:56,2018/11/19 4:26,2018/11/19 4:41,332
332,59,42,17,2018/11/19 4:42,2018/11/19 5:24,2018/11/19 5:40,333
333,51,36,15,2018/11/19 5:41,2018/11/19 6:17,2018/11/19 6:31,334
334,54,38,16,2018/11/19 6:32,2018/11/19 7:10,2018/11/19 7:25,335
335,77,63,14,2018/11/19 7:26,2018/11/19 8:29,2018/11/19 8:42,336
336,40,39,1,2018/11/19 8:43,2018/11/19 9:22,2018/11/19 9:22,337
337,18,4,14,2018/11/19 9:23,2018/11/19 9:27,2018/11/19 9:40,338
338,52,37,15,2018/11/19 9:41,2018/11/19 10:18,2018/11/19 10:32,339
339,60,46,14,2018/11/19 10:33,2018/11/19 11:19,2018/11/19 11:32,340
340,62,47,15,2018/11/19 11:33,2018/11/19 12:20,2018/11/19 12:34,341
341,66,52,14,2018/11/19 12:35,2018/11/19 13:27,2018/11/19 13:40,342
342,68,53,15,2018/11/19 13:41,2018/11/19 14:34,2018/11/19 14:48,343
343,124,110,14,2018/11/19 14:49,2018/11/19 16:39,2018/11/19 16:52,344
344,53,38,15,2018/11/19 16:53,2018/11/19 17:31,2018/11/19 17:45,345
345,61,47,14,2018/11/19 17:46,2018/11/19 18:33,2018/11/19 18:46,346
346,52,38,14,2018/11/19 18:47,2018/11/19 19:25,2018/11/19 19:38,347
347,76,61,15,2018/11/19 19:39,2018/11/19 20:40,2018/11/19 20:54,348
348,52,38,14,2018/11/19 20:55,2018/11/19 21:33,2018/11/19 21:46,349
349,59,45,14,2018/11/19 21:47,2018/11/19 22:32,2018/11/19 22:45,350
350,91,77,14,2018/11/19 22:46,2018/11/20 0:03,2018/11/20 0:16,351
351,56,42,14,2018/11/20 0:17,2018/11/20 0:59,2018/11/20 1:12,352
352,53,38,15,2018/11/20 1:13,2018/11/20 1:51,2018/11/20 2:05,353
353,55,39,16,2018/11/20 2:06,2018/11/20 2:45,2018/11/20 3:00,354
354,99,85,14,2018/11/20 3:01,2018/11/20 4:26,2018/11/20 4:39,355
355,63,48,15,2018/11/20 4:40,2018/11/20 5:28,2018/11/20 5:42,356
356,97,84,13,2018/11/20 5:43,2018/11/20 7:07,2018/11/20 7:19,357
357,82,67,15,2018/11/20 7:20,2018/11/20 8:27,2018/11/20 8:41,358
358,251,236,15,2018/11/20 8:42,2018/11/20 12:38,2018/11/20 12:52,359
359,53,39,14,2018/11/20 12:53,2018/11/20 13:32,2018/11/20 13:45,360
360,50,35,15,2018/11/20 13:46,2018/11/20 14:21,2018/11/20 14:35,361
361,45,31,14,2018/11/20 14:36,2018/11/20 15:07,2018/11/20 15:20,362
362,53,39,14,2018/11/20 15:21,2018/11/20 16:00,2018/11/20 16:13,363
363,63,49,14,2018/11/20 16:14,2018/11/20 17:03,2018/11/20 17:16,364
364,53,38,15,2018/11/20 17:17,2018/11/20 17:55,2018/11/20 18:09,365
365,46,32,14,2018/11/20 18:10,2018/11/20 18:42,2018/11/20 18:55,366
366,56,41,15,2018/11/20 18:56,2018/11/20 19:37,2018/11/20 19:51,367
367,51,35,16,2018/11/20 19:52,2018/11/20 20:27,2018/11/20 20:42,368
368,45,30,15,2018/11/20 20:43,2018/11/20 21:13,2018/11/20 21:27,369
369,48,31,17,2018/11/20 21:28,2018/11/20 21:59,2018/11/20 22:15,370
370,57,43,14,2018/11/20 22:16,2018/11/20 22:59,2018/11/20 23:12,371
371,49,48,1,2018/11/20 23:13,2018/11/21 0:01,2018/11/21 0:01,372
372,17,5,12,2018/11/21 0:02,2018/11/21 0:07,2018/11/21 0:18,373
373,39,37,2,2018/11/21 0:19,2018/11/21 0:56,2018/11/21 0:57,374
374,21,10,11,2018/11/21 0:58,2018/11/21 1:08,2018/11/21 1:18,375
375,37,35,2,2018/11/21 1:19,2018/11/21 1:54,2018/11/21 1:55,376
376,21,10,11,2018/11/21 1:56,2018/11/21 2:06,2018/11/21 2:16,377
377,61,60,1,2018/11/21 2:17,2018/11/21 3:17,2018/11/21 3:17,378
378,22,11,11,2018/11/21 3:18,2018/11/21 3:29,2018/11/21 3:39,379
379,44,30,14,2018/11/21 3:40,2018/11/21 4:10,2018/11/21 4:23,380
380,122,108,14,2018/11/21 4:24,2018/11/21 6:12,2018/11/21 6:25,381
381,50,36,14,2018/11/21 6:26,2018/11/21 7:02,2018/11/21 7:15,382
382,67,51,16,2018/11/21 7:16,2018/11/21 8:07,2018/11/21 8:22,383
383,73,59,14,2018/11/21 8:23,2018/11/21 9:22,2018/11/21 9:35,384
384,64,48,16,2018/11/21 9:36,2018/11/21 10:24,2018/11/21 10:39,385
385,112,97,15,2018/11/21 10:40,2018/11/21 12:17,2018/11/21 12:31,386
386,103,89,14,2018/11/21 12:32,2018/11/21 14:01,2018/11/21 14:14,387
387,62,46,16,2018/11/21 14:15,2018/11/21 15:01,2018/11/21 15:16,388
388,42,41,1,2018/11/21 15:17,2018/11/21 15:58,2018/11/21 15:58,389
389,15,1,14,2018/11/21 15:59,2018/11/21 16:00,2018/11/21 16:13,390
390,62,47,15,2018/11/21 16:14,2018/11/21 17:01,2018/11/21 17:15,391
391,47,33,14,2018/11/21 17:16,2018/11/21 17:49,2018/11/21 18:02,392
392,47,32,15,2018/11/21 18:03,2018/11/21 18:35,2018/11/21 18:49,393
393,64,51,13,2018/11/21 18:50,2018/11/21 19:41,2018/11/21 19:53,394
394,70,58,12,2018/11/21 19:54,2018/11/21 20:52,2018/11/21 21:03,395
395,46,32,14,2018/11/21 21:04,2018/11/21 21:36,2018/11/21 21:49,396
396,63,48,15,2018/11/21 21:50,2018/11/21 22:38,2018/11/21 22:52,397
397,64,49,15,2018/11/21 22:53,2018/11/21 23:42,2018/11/21 23:56,398
398,278,264,14,2018/11/21 23:57,2018/11/22 4:21,2018/11/22 4:34,399
399,39,37,2,2018/11/22 4:35,2018/11/22 5:12,2018/11/22 5:13,400
400,13,1,12,2018/11/22 5:14,2018/11/22 5:15,2018/11/22 5:26,401
401,51,46,5,2018/11/22 5:27,2018/11/22 6:13,2018/11/22 6:17,402
402,13,3,10,2018/11/22 6:18,2018/11/22 6:21,2018/11/22 6:30,403
403,53,38,15,2018/11/22 6:31,2018/11/22 7:09,2018/11/22 7:23,404
404,34,21,13,2018/11/22 7:24,2018/11/22 7:45,2018/11/22 7:57,405
405,77,63,14,2018/11/22 7:58,2018/11/22 9:01,2018/11/22 9:14,406
406,50,35,15,2018/11/22 9:15,2018/11/22 9:50,2018/11/22 10:04,407
407,55,43,12,2018/11/22 10:05,2018/11/22 10:48,2018/11/22 10:59,408
408,48,40,8,2018/11/22 11:00,2018/11/22 11:40,2018/11/22 11:47,409
409,5,1,4,2018/11/22 11:48,2018/11/22 11:49,2018/11/22 11:52,410
410,31,29,2,2018/11/22 11:53,2018/11/22 12:22,2018/11/22 12:23,411
411,18,6,12,2018/11/22 12:24,2018/11/22 12:30,2018/11/22 12:41,412
412,40,25,15,2018/11/22 12:42,2018/11/22 13:07,2018/11/22 13:21,413
413,49,34,15,2018/11/22 13:22,2018/11/22 13:56,2018/11/22 14:10,414
414,42,28,14,2018/11/22 14:11,2018/11/22 14:39,2018/11/22 14:52,415
415,42,27,15,2018/11/22 14:53,2018/11/22 15:20,2018/11/22 15:34,416
416,59,45,14,2018/11/22 15:35,2018/11/22 16:20,2018/11/22 16:33,417
417,75,59,16,2018/11/22 16:34,2018/11/22 17:33,2018/11/22 17:48,418
418,44,43,1,2018/11/22 17:49,2018/11/22 18:32,2018/11/22 18:32,419
419,19,6,13,2018/11/22 18:33,2018/11/22 18:39,2018/11/22 18:51,420
420,54,40,14,2018/11/22 18:52,2018/11/22 19:32,2018/11/22 19:45,421
421,47,33,14,2018/11/22 19:46,2018/11/22 20:19,2018/11/22 20:32,422
422,52,40,12,2018/11/22 20:33,2018/11/22 21:13,2018/11/22 21:24,423
423,61,47,14,2018/11/22 21:25,2018/11/22 22:12,2018/11/22 22:25,424
424,138,124,14,2018/11/22 22:26,2018/11/23 0:30,2018/11/23 0:43,425
425,53,38,15,2018/11/23 0:44,2018/11/23 1:22,2018/11/23 1:36,426
426,49,33,16,2018/11/23 1:37,2018/11/23 2:10,2018/11/23 2:25,427
427,51,36,15,2018/11/23 2:26,2018/11/23 3:02,2018/11/23 3:16,428
428,55,40,15,2018/11/23 3:17,2018/11/23 3:57,2018/11/23 4:11,429
429,49,34,15,2018/11/23 4:12,2018/11/23 4:46,2018/11/23 5:00,430
430,49,34,15,2018/11/23 5:01,2018/11/23 5:35,2018/11/23 5:49,431
431,47,34,13,2018/11/23 5:50,2018/11/23 6:24,2018/11/23 6:36,432
432,48,33,15,2018/11/23 6:37,2018/11/23 7:10,2018/11/23 7:24,433
433,60,46,14,2018/11/23 7:25,2018/11/23 8:11,2018/11/23 8:24,434
434,52,37,15,2018/11/23 8:25,2018/11/23 9:02,2018/11/23 9:16,435
435,82,67,15,2018/11/23 9:17,2018/11/23 10:24,2018/11/23 10:38,436
436,73,58,15,2018/11/23 10:39,2018/11/23 11:37,2018/11/23 11:51,437
437,52,36,16,2018/11/23 11:52,2018/11/23 12:28,2018/11/23 12:43,438
438,57,40,17,2018/11/23 12:44,2018/11/23 13:24,2018/11/23 13:40,439
439,77,61,16,2018/11/23 13:41,2018/11/23 14:42,2018/11/23 14:57,440
440,63,47,16,2018/11/23 14:58,2018/11/23 15:45,2018/11/23 16:00,441
441,50,34,16,2018/11/23 16:01,2018/11/23 16:35,2018/11/23 16:50,442
442,78,64,14,2018/11/23 16:51,2018/11/23 17:55,2018/11/23 18:08,443
443,63,50,13,2018/11/23 18:09,2018/11/23 18:59,2018/11/23 19:11,444
444,47,32,15,2018/11/23 19:12,2018/11/23 19:44,2018/11/23 19:58,445
445,53,39,14,2018/11/23 19:59,2018/11/23 20:38,2018/11/23 20:51,446
446,57,41,16,2018/11/23 20:52,2018/11/23 21:33,2018/11/23 21:48,447
447,47,32,15,2018/11/23 21:49,2018/11/23 22:21,2018/11/23 22:35,448
448,61,57,4,2018/11/23 22:36,2018/11/23 23:33,2018/11/23 23:36,449
449,13,3,10,2018/11/23 23:37,2018/11/23 23:40,2018/11/23 23:49,450
450,77,61,16,2018/11/23 23:50,2018/11/24 0:51,2018/11/24 1:06,451
451,55,40,15,2018/11/24 1:07,2018/11/24 1:47,2018/11/24 2:01,452
452,51,36,15,2018/11/24 2:02,2018/11/24 2:38,2018/11/24 2:52,453
453,73,58,15,2018/11/24 2:53,2018/11/24 3:51,2018/11/24 4:05,454
454,73,58,15,2018/11/24 4:06,2018/11/24 5:04,2018/11/24 5:18,455
455,65,49,16,2018/11/24 5:19,2018/11/24 6:08,2018/11/24 6:23,456
456,46,32,14,2018/11/24 6:24,2018/11/24 6:56,2018/11/24 7:09,457
457,44,29,15,2018/11/24 7:10,2018/11/24 7:39,2018/11/24 7:53,458
458,93,78,15,2018/11/24 7:54,2018/11/24 9:12,2018/11/24 9:26,459
459,68,52,16,2018/11/24 9:27,2018/11/24 10:19,2018/11/24 10:34,460
460,50,35,15,2018/11/24 10:35,2018/11/24 11:10,2018/11/24 11:24,461
461,69,54,15,2018/11/24 11:25,2018/11/24 12:19,2018/11/24 12:33,462
462,62,49,13,2018/11/24 12:34,2018/11/24 13:23,2018/11/24 13:35,463
463,64,48,16,2018/11/24 13:36,2018/11/24 14:24,2018/11/24 14:39,464
464,55,41,14,2018/11/24 14:40,2018/11/24 15:21,2018/11/24 15:34,465
465,57,42,15,2018/11/24 15:35,2018/11/24 16:17,2018/11/24 16:31,466
466,55,37,18,2018/11/24 16:32,2018/11/24 17:09,2018/11/24 17:26,467
467,45,30,15,2018/11/24 17:27,2018/11/24 17:57,2018/11/24 18:11,468
468,58,43,15,2018/11/24 18:12,2018/11/24 18:55,2018/11/24 19:09,469
469,42,29,13,2018/11/24 19:10,2018/11/24 19:39,2018/11/24 19:51,470
470,97,83,14,2018/11/24 19:52,2018/11/24 21:15,2018/11/24 21:28,471
471,54,38,16,2018/11/24 21:29,2018/11/24 22:07,2018/11/24 22:22,472
472,44,29,15,2018/11/24 22:23,2018/11/24 22:52,2018/11/24 23:06,473
473,46,30,16,2018/11/24 23:07,2018/11/24 23:37,2018/11/24 23:52,474
474,62,48,14,2018/11/24 23:53,2018/11/25 0:41,2018/11/25 0:54,475
475,48,33,15,2018/11/25 0:55,2018/11/25 1:28,2018/11/25 1:42,476
476,87,72,15,2018/11/25 1:43,2018/11/25 2:55,2018/11/25 3:09,477
477,91,74,17,2018/11/25 3:10,2018/11/25 4:24,2018/11/25 4:40,478
478,56,41,15,2018/11/25 4:41,2018/11/25 5:22,2018/11/25 5:36,479
479,50,34,16,2018/11/25 5:37,2018/11/25 6:11,2018/11/25 6:26,480
480,61,45,16,2018/11/25 6:27,2018/11/25 7:12,2018/11/25 7:27,481
481,65,50,15,2018/11/25 7:28,2018/11/25 8:18,2018/11/25 8:32,482
482,69,54,15,2018/11/25 8:33,2018/11/25 9:27,2018/11/25 9:41,483
483,56,41,15,2018/11/25 9:42,2018/11/25 10:23,2018/11/25 10:37,484
484,55,44,11,2018/11/25 10:38,2018/11/25 11:22,2018/11/25 11:32,485
485,12,8,4,2018/11/25 11:33,2018/11/25 11:41,2018/11/25 11:44,486
486,57,42,15,2018/11/25 11:45,2018/11/25 12:27,2018/11/25 12:41,487
487,58,42,16,2018/11/25 12:42,2018/11/25 13:24,2018/11/25 13:39,488
488,78,62,16,2018/11/25 13:40,2018/11/25 14:42,2018/11/25 14:57,489
489,87,71,16,2018/11/25 14:58,2018/11/25 16:09,2018/11/25 16:24,490
490,61,46,15,2018/11/25 16:25,2018/11/25 17:11,2018/11/25 17:25,491
491,52,38,14,2018/11/25 17:26,2018/11/25 18:04,2018/11/25 18:17,492
492,59,45,14,2018/11/25 18:18,2018/11/25 19:03,2018/11/25 19:16,493
493,42,30,12,2018/11/25 19:17,2018/11/25 19:47,2018/11/25 19:58,494
494,95,79,16,2018/11/25 19:59,2018/11/25 21:18,2018/11/25 21:33,495
495,52,38,14,2018/11/25 21:34,2018/11/25 22:12,2018/11/25 22:25,496
496,54,39,15,2018/11/25 22:26,2018/11/25 23:05,2018/11/25 23:19,497
497,46,32,14,2018/11/25 23:20,2018/11/25 23:52,2018/11/26 0:05,498
498,56,41,15,2018/11/26 0:06,2018/11/26 0:47,2018/11/26 1:01,499
499,59,43,16,2018/11/26 1:02,2018/11/26 1:45,2018/11/26 2:00,500
500,56,41,15,2018/11/26 2:01,2018/11/26 2:42,2018/11/26 2:56,501
501,92,77,15,2018/11/26 2:57,2018/11/26 4:14,2018/11/26 4:28,502
502,66,51,15,2018/11/26 4:29,2018/11/26 5:20,2018/11/26 5:34,503
503,56,42,14,2018/11/26 5:35,2018/11/26 6:17,2018/11/26 6:30,504
504,71,57,14,2018/11/26 6:31,2018/11/26 7:28,2018/11/26 7:41,505
505,62,48,14,2018/11/26 7:42,2018/11/26 8:30,2018/11/26 8:43,506
506,53,40,13,2018/11/26 8:44,2018/11/26 9:24,2018/11/26 9:36,507
507,74,59,15,2018/11/26 9:37,2018/11/26 10:36,2018/11/26 10:50,508
508,55,40,15,2018/11/26 10:51,2018/11/26 11:31,2018/11/26 11:45,509
509,56,41,15,2018/11/26 11:46,2018/11/26 12:27,2018/11/26 12:41,510
510,68,55,13,2018/11/26 12:42,2018/11/26 13:37,2018/11/26 13:49,511
511,46,32,14,2018/11/26 13:50,2018/11/26 14:22,2018/11/26 14:35,512
512,59,45,14,2018/11/26 14:36,2018/11/26 15:21,2018/11/26 15:34,513
513,59,45,14,2018/11/26 15:35,2018/11/26 16:20,2018/11/26 16:33,514
514,50,35,15,2018/11/26 16:34,2018/11/26 17:09,2018/11/26 17:23,515
515,54,39,15,2018/11/26 17:24,2018/11/26 18:03,2018/11/26 18:17,516
516,49,34,15,2018/11/26 18:18,2018/11/26 18:52,2018/11/26 19:06,517
517,53,40,13,2018/11/26 19:07,2018/11/26 19:47,2018/11/26 19:59,518
518,75,59,16,2018/11/26 20:00,2018/11/26 20:59,2018/11/26 21:14,519
519,80,66,14,2018/11/26 21:15,2018/11/26 22:21,2018/11/26 22:34,520
520,49,34,15,2018/11/26 22:35,2018/11/26 23:09,2018/11/26 23:23,521
521,56,41,15,2018/11/26 23:24,2018/11/27 0:05,2018/11/27 0:19,522
522,44,29,15,2018/11/27 0:20,2018/11/27 0:49,2018/11/27 1:03,523
523,47,32,15,2018/11/27 1:04,2018/11/27 1:36,2018/11/27 1:50,524
524,80,64,16,2018/11/27 1:51,2018/11/27 2:55,2018/11/27 3:10,525
525,49,34,15,2018/11/27 3:11,2018/11/27 3:45,2018/11/27 3:59,526
526,70,55,15,2018/11/27 4:00,2018/11/27 4:55,2018/11/27 5:09,527
527,60,46,14,2018/11/27 5:10,2018/11/27 5:56,2018/11/27 6:09,528
528,45,32,13,2018/11/27 6:10,2018/11/27 6:42,2018/11/27 6:54,529
529,54,39,15,2018/11/27 6:55,2018/11/27 7:34,2018/11/27 7:48,530
530,55,41,14,2018/11/27 7:49,2018/11/27 8:30,2018/11/27 8:43,531
531,58,43,15,2018/11/27 8:44,2018/11/27 9:27,2018/11/27 9:41,532
532,52,38,14,2018/11/27 9:42,2018/11/27 10:20,2018/11/27 10:33,533
533,59,43,16,2018/11/27 10:34,2018/11/27 11:17,2018/11/27 11:32,534
534,46,32,14,2018/11/27 11:33,2018/11/27 12:05,2018/11/27 12:18,535
535,66,51,15,2018/11/27 12:19,2018/11/27 13:10,2018/11/27 13:24,536
536,52,37,15,2018/11/27 13:25,2018/11/27 14:02,2018/11/27 14:16,537
537,92,77,15,2018/11/27 14:17,2018/11/27 15:34,2018/11/27 15:48,538
538,46,32,14,2018/11/27 15:49,2018/11/27 16:21,2018/11/27 16:34,539
539,53,39,14,2018/11/27 16:35,2018/11/27 17:14,2018/11/27 17:27,540
540,45,30,15,2018/11/27 17:28,2018/11/27 17:58,2018/11/27 18:12,541
541,88,73,15,2018/11/27 18:13,2018/11/27 19:26,2018/11/27 19:40,542
542,64,50,14,2018/11/27 19:41,2018/11/27 20:31,2018/11/27 20:44,543
543,66,51,15,2018/11/27 20:45,2018/11/27 21:36,2018/11/27 21:50,544
544,61,45,16,2018/11/27 21:51,2018/11/27 22:36,2018/11/27 22:51,545
545,63,48,15,2018/11/27 22:52,2018/11/27 23:40,2018/11/27 23:54,546
546,46,33,13,2018/11/27 23:55,2018/11/28 0:28,2018/11/28 0:40,547
547,58,43,15,2018/11/28 0:41,2018/11/28 1:24,2018/11/28 1:38,548
548,56,40,16,2018/11/28 1:39,2018/11/28 2:19,2018/11/28 2:34,549
549,63,47,16,2018/11/28 2:35,2018/11/28 3:22,2018/11/28 3:37,550
550,60,46,14,2018/11/28 3:38,2018/11/28 4:24,2018/11/28 4:37,551
551,95,82,13,2018/11/28 4:38,2018/11/28 6:00,2018/11/28 6:12,552
552,58,45,13,2018/11/28 6:13,2018/11/28 6:58,2018/11/28 7:10,553
553,90,76,14,2018/11/28 7:11,2018/11/28 8:27,2018/11/28 8:40,554
554,2,1,1,2018/11/28 8:41,2018/11/28 8:42,2018/11/28 8:42,555
555,66,52,14,2018/11/28 8:43,2018/11/28 9:35,2018/11/28 9:48,556
556,58,44,14,2018/11/28 9:49,2018/11/28 10:33,2018/11/28 10:46,557
557,58,43,15,2018/11/28 10:47,2018/11/28 11:30,2018/11/28 11:44,558
558,46,31,15,2018/11/28 11:45,2018/11/28 12:16,2018/11/28 12:30,559
559,59,44,15,2018/11/28 12:31,2018/11/28 13:15,2018/11/28 13:29,560
560,79,64,15,2018/11/28 13:30,2018/11/28 14:34,2018/11/28 14:48,561
561,96,78,18,2018/11/28 14:49,2018/11/28 16:07,2018/11/28 16:24,562
562,56,41,15,2018/11/28 16:25,2018/11/28 17:06,2018/11/28 17:20,563
563,47,30,17,2018/11/28 17:21,2018/11/28 17:51,2018/11/28 18:07,564
564,64,50,14,2018/11/28 18:08,2018/11/28 18:58,2018/11/28 19:11,565
565,45,31,14,2018/11/28 19:12,2018/11/28 19:43,2018/11/28 19:56,566
566,52,37,15,2018/11/28 19:57,2018/11/28 20:34,2018/11/28 20:48,567
567,53,38,15,2018/11/28 20:49,2018/11/28 21:27,2018/11/28 21:41,568
568,52,38,14,2018/11/28 21:42,2018/11/28 22:20,2018/11/28 22:33,569
569,42,28,14,2018/11/28 22:34,2018/11/28 23:02,2018/11/28 23:15,570
570,104,89,15,2018/11/28 23:16,2018/11/29 0:45,2018/11/29 0:59,571
571,54,39,15,2018/11/29 1:00,2018/11/29 1:39,2018/11/29 1:53,572
572,60,47,13,2018/11/29 1:54,2018/11/29 2:41,2018/11/29 2:53,573
573,46,32,14,2018/11/29 2:54,2018/11/29 3:26,2018/11/29 3:39,574
574,56,41,15,2018/11/29 3:40,2018/11/29 4:21,2018/11/29 4:35,575
575,49,34,15,2018/11/29 4:36,2018/11/29 5:10,2018/11/29 5:24,576
576,58,43,15,2018/11/29 5:25,2018/11/29 6:08,2018/11/29 6:22,577
577,46,32,14,2018/11/29 6:23,2018/11/29 6:55,2018/11/29 7:08,578
578,49,33,16,2018/11/29 7:09,2018/11/29 7:42,2018/11/29 7:57,579
579,90,76,14,2018/11/29 7:58,2018/11/29 9:14,2018/11/29 9:27,580
580,49,33,16,2018/11/29 9:28,2018/11/29 10:01,2018/11/29 10:16,581
581,62,47,15,2018/11/29 10:17,2018/11/29 11:04,2018/11/29 11:18,582
582,57,43,14,2018/11/29 11:19,2018/11/29 12:02,2018/11/29 12:15,583
583,46,31,15,2018/11/29 12:16,2018/11/29 12:47,2018/11/29 13:01,584
584,54,39,15,2018/11/29 13:02,2018/11/29 13:41,2018/11/29 13:55,585
585,50,35,15,2018/11/29 13:56,2018/11/29 14:31,2018/11/29 14:45,586
586,79,66,13,2018/11/29 14:46,2018/11/29 15:52,2018/11/29 16:04,587
587,45,30,15,2018/11/29 16:05,2018/11/29 16:35,2018/11/29 16:49,588
588,42,39,3,2018/11/29 16:50,2018/11/29 17:29,2018/11/29 17:31,589
589,16,5,11,2018/11/29 17:32,2018/11/29 17:37,2018/11/29 17:47,590
590,43,28,15,2018/11/29 17:48,2018/11/29 18:16,2018/11/29 18:30,591
591,56,42,14,2018/11/29 18:31,2018/11/29 19:13,2018/11/29 19:26,592
592,56,39,17,2018/11/29 19:27,2018/11/29 20:06,2018/11/29 20:22,593
593,63,47,16,2018/11/29 20:23,2018/11/29 21:10,2018/11/29 21:25,594
594,45,30,15,2018/11/29 21:26,2018/11/29 21:56,2018/11/29 22:10,595
595,126,113,13,2018/11/29 22:11,2018/11/30 0:04,2018/11/30 0:16,596
596,59,45,14,2018/11/30 0:17,2018/11/30 1:02,2018/11/30 1:15,597
597,59,44,15,2018/11/30 1:16,2018/11/30 2:00,2018/11/30 2:14,598
598,68,55,13,2018/11/30 2:15,2018/11/30 3:10,2018/11/30 3:22,599
599,147,132,15,2018/11/30 3:23,2018/11/30 5:35,2018/11/30 5:49,600
600,58,43,15,2018/11/30 5:50,2018/11/30 6:33,2018/11/30 6:47,601
601,65,50,15,2018/11/30 6:48,2018/11/30 7:38,2018/11/30 7:52,602
602,56,42,14,2018/11/30 7:53,2018/11/30 8:35,2018/11/30 8:48,603
603,56,41,15,2018/11/30 8:49,2018/11/30 9:30,2018/11/30 9:44,604
604,57,43,14,2018/11/30 9:45,2018/11/30 10:28,2018/11/30 10:41,605
605,60,44,16,2018/11/30 10:42,2018/11/30 11:26,2018/11/30 11:41,606
606,760,748,12,2018/11/30 11:42,2018/12/1 0:10,2018/12/1 0:21,607
607,58,44,14,2018/12/1 0:22,2018/12/1 1:06,2018/12/1 1:19,608
608,51,36,15,2018/12/1 1:20,2018/12/1 1:56,2018/12/1 2:10,609
609,48,35,13,2018/12/1 2:11,2018/12/1 2:46,2018/12/1 2:58,610
610,67,52,15,2018/12/1 2:59,2018/12/1 3:51,2018/12/1 4:05,611
611,61,60,1,2018/12/1 4:06,2018/12/1 5:06,2018/12/1 5:06,612
612,21,8,13,2018/12/1 5:07,2018/12/1 5:15,2018/12/1 5:27,613
613,56,41,15,2018/12/1 5:28,2018/12/1 6:09,2018/12/1 6:23,614
614,51,37,14,2018/12/1 6:24,2018/12/1 7:01,2018/12/1 7:14,615
615,73,59,14,2018/12/1 7:15,2018/12/1 8:14,2018/12/1 8:27,616
616,64,62,2,2018/12/1 8:28,2018/12/1 9:30,2018/12/1 9:31,617
617,12,1,11,2018/12/1 9:32,2018/12/1 9:33,2018/12/1 9:43,618
618,54,40,14,2018/12/1 9:44,2018/12/1 10:24,2018/12/1 10:37,619
619,51,36,15,2018/12/1 10:38,2018/12/1 11:14,2018/12/1 11:28,620
620,56,43,13,2018/12/1 11:29,2018/12/1 12:12,2018/12/1 12:24,621
621,53,40,13,2018/12/1 12:25,2018/12/1 13:05,2018/12/1 13:17,622
622,61,47,14,2018/12/1 13:18,2018/12/1 14:05,2018/12/1 14:18,623
623,60,46,14,2018/12/1 14:19,2018/12/1 15:05,2018/12/1 15:18,624
624,2,1,1,2018/12/1 15:19,2018/12/1 15:20,2018/12/1 15:20,625
625,89,74,15,2018/12/1 15:21,2018/12/1 16:35,2018/12/1 16:49,626
626,64,49,15,2018/12/1 16:50,2018/12/1 17:39,2018/12/1 17:53,627
627,63,50,13,2018/12/1 17:54,2018/12/1 18:44,2018/12/1 18:56,628
628,50,37,13,2018/12/1 18:57,2018/12/1 19:34,2018/12/1 19:46,629
629,54,40,14,2018/12/1 19:47,2018/12/1 20:27,2018/12/1 20:40,630
630,49,35,14,2018/12/1 20:41,2018/12/1 21:16,2018/12/1 21:29,631
631,118,103,15,2018/12/1 21:30,2018/12/1 23:13,2018/12/1 23:27,632
632,45,30,15,2018/12/1 23:28,2018/12/1 23:58,2018/12/2 0:12,633
633,135,119,16,2018/12/2 0:13,2018/12/2 2:12,2018/12/2 2:27,634
634,85,70,15,2018/12/2 2:28,2018/12/2 3:38,2018/12/2 3:52,635
635,46,32,14,2018/12/2 3:53,2018/12/2 4:25,2018/12/2 4:38,636
636,48,33,15,2018/12/2 4:39,2018/12/2 5:12,2018/12/2 5:26,637
637,44,30,14,2018/12/2 5:27,2018/12/2 5:57,2018/12/2 6:10,638
638,74,59,15,2018/12/2 6:11,2018/12/2 7:10,2018/12/2 7:24,639
639,111,97,14,2018/12/2 7:25,2018/12/2 9:02,2018/12/2 9:15,640
640,46,32,14,2018/12/2 9:16,2018/12/2 9:48,2018/12/2 10:01,641
641,41,28,13,2018/12/2 10:02,2018/12/2 10:30,2018/12/2 10:42,642
642,48,33,15,2018/12/2 10:43,2018/12/2 11:16,2018/12/2 11:30,643
643,38,24,14,2018/12/2 11:31,2018/12/2 11:55,2018/12/2 12:08,644
644,40,27,13,2018/12/2 12:09,2018/12/2 12:36,2018/12/2 12:48,645
645,39,24,15,2018/12/2 12:49,2018/12/2 13:13,2018/12/2 13:27,646
646,35,33,2,2018/12/2 13:28,2018/12/2 14:01,2018/12/2 14:02,647
647,22,10,12,2018/12/2 14:03,2018/12/2 14:13,2018/12/2 14:24,648
648,40,25,15,2018/12/2 14:25,2018/12/2 14:50,2018/12/2 15:04,649
649,47,34,13,2018/12/2 15:05,2018/12/2 15:39,2018/12/2 15:51,650
650,40,37,3,2018/12/2 15:52,2018/12/2 16:29,2018/12/2 16:31,651
651,22,10,12,2018/12/2 16:32,2018/12/2 16:42,2018/12/2 16:53,652
652,41,38,3,2018/12/2 16:54,2018/12/2 17:32,2018/12/2 17:34,653
653,13,3,10,2018/12/2 17:35,2018/12/2 17:38,2018/12/2 17:47,654
654,59,45,14,2018/12/2 17:48,2018/12/2 18:33,2018/12/2 18:46,655
655,59,44,15,2018/12/2 18:47,2018/12/2 19:31,2018/12/2 19:45,656
656,39,26,13,2018/12/2 19:46,2018/12/2 20:12,2018/12/2 20:24,657
657,34,30,4,2018/12/2 20:25,2018/12/2 20:55,2018/12/2 20:58,658
658,12,3,9,2018/12/2 20:59,2018/12/2 21:02,2018/12/2 21:10,659
659,39,26,13,2018/12/2 21:11,2018/12/2 21:37,2018/12/2 21:49,660
660,58,45,13,2018/12/2 21:50,2018/12/2 22:35,2018/12/2 22:47,661
661,40,26,14,2018/12/2 22:48,2018/12/2 23:14,2018/12/2 23:27,662
662,59,45,14,2018/12/2 23:28,2018/12/3 0:13,2018/12/3 0:26,663
663,43,29,14,2018/12/3 0:27,2018/12/3 0:56,2018/12/3 1:09,664
664,56,42,14,2018/12/3 1:10,2018/12/3 1:52,2018/12/3 2:05,665
665,47,34,13,2018/12/3 2:06,2018/12/3 2:40,2018/12/3 2:52,666
666,57,43,14,2018/12/3 2:53,2018/12/3 3:36,2018/12/3 3:49,667
667,43,29,14,2018/12/3 3:50,2018/12/3 4:19,2018/12/3 4:32,668
668,42,28,14,2018/12/3 4:33,2018/12/3 5:01,2018/12/3 5:14,669
669,48,35,13,2018/12/3 5:15,2018/12/3 5:50,2018/12/3 6:02,670
670,69,56,13,2018/12/3 6:03,2018/12/3 6:59,2018/12/3 7:11,671
671,43,29,14,2018/12/3 7:12,2018/12/3 7:41,2018/12/3 7:54,672
672,48,35,13,2018/12/3 7:55,2018/12/3 8:30,2018/12/3 8:42,673
673,41,28,13,2018/12/3 8:43,2018/12/3 9:11,2018/12/3 9:23,674
674,48,35,13,2018/12/3 9:24,2018/12/3 9:59,2018/12/3 10:11,675
675,40,26,14,2018/12/3 10:12,2018/12/3 10:38,2018/12/3 10:51,676
676,40,27,13,2018/12/3 10:52,2018/12/3 11:20,2018/12/3 11:31,677
677,47,33,14,2018/12/3 11:32,2018/12/3 12:05,2018/12/3 12:18,678
678,64,50,14,2018/12/3 12:19,2018/12/3 13:09,2018/12/3 13:22,679
679,45,31,14,2018/12/3 13:23,2018/12/3 13:54,2018/12/3 14:07,680
680,41,27,14,2018/12/3 14:08,2018/12/3 14:35,2018/12/3 14:48,681
681,28,24,4,2018/12/3 14:49,2018/12/3 15:13,2018/12/3 15:16,682
682,15,5,10,2018/12/3 15:17,2018/12/3 15:22,2018/12/3 15:31,683
683,47,33,14,2018/12/3 15:32,2018/12/3 16:05,2018/12/3 16:18,684
684,44,32,12,2018/12/3 16:19,2018/12/3 16:51,2018/12/3 17:02,685
685,41,27,14,2018/12/3 17:03,2018/12/3 17:30,2018/12/3 17:43,686
686,38,24,14,2018/12/3 17:44,2018/12/3 18:08,2018/12/3 18:21,687
687,48,35,13,2018/12/3 18:22,2018/12/3 18:57,2018/12/3 19:09,688
688,44,30,14,2018/12/3 19:10,2018/12/3 19:40,2018/12/3 19:53,689
689,64,49,15,2018/12/3 19:54,2018/12/3 20:43,2018/12/3 20:57,690
690,43,30,13,2018/12/3 20:58,2018/12/3 21:28,2018/12/3 21:40,691
691,61,48,13,2018/12/3 21:41,2018/12/3 22:29,2018/12/3 22:41,692
692,41,38,3,2018/12/3 22:42,2018/12/3 23:20,2018/12/3 23:22,693
693,14,3,11,2018/12/3 23:23,2018/12/3 23:26,2018/12/3 23:36,694
694,41,27,14,2018/12/3 23:37,2018/12/4 0:04,2018/12/4 0:17,695
695,45,30,15,2018/12/4 0:18,2018/12/4 0:48,2018/12/4 1:02,696
696,46,31,15,2018/12/4 1:03,2018/12/4 1:34,2018/12/4 1:48,697
697,46,32,14,2018/12/4 1:49,2018/12/4 2:21,2018/12/4 2:34,698
698,43,28,15,2018/12/4 2:35,2018/12/4 3:03,2018/12/4 3:17,699
699,56,41,15,2018/12/4 3:18,2018/12/4 3:59,2018/12/4 4:13,700
700,42,26,16,2018/12/4 4:14,2018/12/4 4:40,2018/12/4 4:55,701
701,49,34,15,2018/12/4 4:56,2018/12/4 5:30,2018/12/4 5:44,702
702,40,26,14,2018/12/4 5:45,2018/12/4 6:11,2018/12/4 6:24,703
703,41,27,14,2018/12/4 6:25,2018/12/4 6:52,2018/12/4 7:05,704
704,50,35,15,2018/12/4 7:06,2018/12/4 7:41,2018/12/4 7:55,705
705,43,30,13,2018/12/4 7:56,2018/12/4 8:26,2018/12/4 8:38,706
706,55,40,15,2018/12/4 8:39,2018/12/4 9:19,2018/12/4 9:33,707
707,43,29,14,2018/12/4 9:34,2018/12/4 10:03,2018/12/4 10:16,708
708,39,25,14,2018/12/4 10:17,2018/12/4 10:42,2018/12/4 10:55,709
709,54,39,15,2018/12/4 10:56,2018/12/4 11:35,2018/12/4 11:49,710
710,31,27,4,2018/12/4 11:50,2018/12/4 12:17,2018/12/4 12:20,711
711,13,3,10,2018/12/4 12:21,2018/12/4 12:24,2018/12/4 12:33,712
712,38,24,14,2018/12/4 12:34,2018/12/4 12:58,2018/12/4 13:11,713
713,39,23,16,2018/12/4 13:12,2018/12/4 13:35,2018/12/4 13:50,714
714,51,36,15,2018/12/4 13:51,2018/12/4 14:27,2018/12/4 14:41,715
715,28,23,5,2018/12/4 14:42,2018/12/4 15:05,2018/12/4 15:09,716
716,14,3,11,2018/12/4 15:10,2018/12/4 15:13,2018/12/4 15:23,717
717,41,25,16,2018/12/4 15:24,2018/12/4 15:49,2018/12/4 16:04,718
718,38,24,14,2018/12/4 16:05,2018/12/4 16:29,2018/12/4 16:42,719
719,39,24,15,2018/12/4 16:43,2018/12/4 17:07,2018/12/4 17:21,720
720,59,44,15,2018/12/4 17:22,2018/12/4 18:06,2018/12/4 18:20,721
721,35,31,4,2018/12/4 18:21,2018/12/4 18:52,2018/12/4 18:55,722
722,14,2,12,2018/12/4 18:56,2018/12/4 18:58,2018/12/4 19:09,723
723,41,26,15,2018/12/4 19:10,2018/12/4 19:36,2018/12/4 19:50,724
724,45,30,15,2018/12/4 19:51,2018/12/4 20:21,2018/12/4 20:35,725
725,28,24,4,2018/12/4 20:36,2018/12/4 21:00,2018/12/4 21:03,726
726,14,5,9,2018/12/4 21:04,2018/12/4 21:09,2018/12/4 21:17,727
727,40,26,14,2018/12/4 21:18,2018/12/4 21:44,2018/12/4 21:57,728
728,40,25,15,2018/12/4 21:58,2018/12/4 22:23,2018/12/4 22:37,729
729,33,24,9,2018/12/4 22:38,2018/12/4 23:02,2018/12/4 23:10,730
730,49,35,14,2018/12/4 23:11,2018/12/4 23:46,2018/12/4 23:59,731
731,45,32,13,2018/12/5 0:00,2018/12/5 0:32,2018/12/5 0:44,732
732,71,58,13,2018/12/5 0:45,2018/12/5 1:43,2018/12/5 1:55,733
733,39,25,14,2018/12/5 1:56,2018/12/5 2:21,2018/12/5 2:34,734
734,60,47,13,2018/12/5 2:35,2018/12/5 3:22,2018/12/5 3:34,735
735,43,28,15,2018/12/5 3:35,2018/12/5 4:03,2018/12/5 4:17,736
736,38,24,14,2018/12/5 4:18,2018/12/5 4:42,2018/12/5 4:55,737
737,62,49,13,2018/12/5 4:56,2018/12/5 5:45,2018/12/5 5:57,738
738,64,50,14,2018/12/5 5:58,2018/12/5 6:48,2018/12/5 7:01,739
739,72,57,15,2018/12/5 7:02,2018/12/5 7:59,2018/12/5 8:13,740
740,49,35,14,2018/12/5 8:14,2018/12/5 8:49,2018/12/5 9:02,741
741,94,79,15,2018/12/5 9:03,2018/12/5 10:22,2018/12/5 10:36,742
742,64,49,15,2018/12/5 10:37,2018/12/5 11:26,2018/12/5 11:40,743
743,44,31,13,2018/12/5 11:41,2018/12/5 12:12,2018/12/5 12:24,744
744,44,30,14,2018/12/5 12:25,2018/12/5 12:55,2018/12/5 13:08,745
745,85,71,14,2018/12/5 13:09,2018/12/5 14:20,2018/12/5 14:33,746
746,49,34,15,2018/12/5 14:34,2018/12/5 15:08,2018/12/5 15:22,747
747,47,31,16,2018/12/5 15:23,2018/12/5 15:54,2018/12/5 16:09,748
748,79,63,16,2018/12/5 16:10,2018/12/5 17:13,2018/12/5 17:28,749
749,56,43,13,2018/12/5 17:29,2018/12/5 18:12,2018/12/5 18:24,750
750,43,28,15,2018/12/5 18:25,2018/12/5 18:53,2018/12/5 19:07,751
751,45,29,16,2018/12/5 19:08,2018/12/5 19:37,2018/12/5 19:52,752
752,44,29,15,2018/12/5 19:53,2018/12/5 20:22,2018/12/5 20:36,753
753,60,45,15,2018/12/5 20:37,2018/12/5 21:22,2018/12/5 21:36,754
754,58,43,15,2018/12/5 21:37,2018/12/5 22:20,2018/12/5 22:34,755
755,39,24,15,2018/12/5 22:35,2018/12/5 22:59,2018/12/5 23:13,756
756,76,61,15,2018/12/5 23:14,2018/12/6 0:15,2018/12/6 0:29,757
757,81,66,15,2018/12/6 0:30,2018/12/6 1:36,2018/12/6 1:50,758
758,53,39,14,2018/12/6 1:51,2018/12/6 2:30,2018/12/6 2:43,759
759,56,41,15,2018/12/6 2:44,2018/12/6 3:25,2018/12/6 3:39,760
760,55,41,14,2018/12/6 3:40,2018/12/6 4:21,2018/12/6 4:34,761
761,43,28,15,2018/12/6 4:35,2018/12/6 5:03,2018/12/6 5:17,762
762,49,34,15,2018/12/6 5:18,2018/12/6 5:52,2018/12/6 6:06,763
763,40,25,15,2018/12/6 6:07,2018/12/6 6:32,2018/12/6 6:46,764
764,46,32,14,2018/12/6 6:47,2018/12/6 7:19,2018/12/6 7:32,765
765,143,142,1,2018/12/6 7:33,2018/12/6 9:55,2018/12/6 9:55,766
766,14,1,13,2018/12/6 9:56,2018/12/6 9:57,2018/12/6 10:09,767
767,57,44,13,2018/12/6 10:10,2018/12/6 10:54,2018/12/6 11:06,768
768,50,36,14,2018/12/6 11:07,2018/12/6 11:43,2018/12/6 11:56,769
769,39,25,14,2018/12/6 11:57,2018/12/6 12:22,2018/12/6 12:35,770
770,57,43,14,2018/12/6 12:36,2018/12/6 13:19,2018/12/6 13:32,771
771,52,40,12,2018/12/6 13:33,2018/12/6 14:13,2018/12/6 14:24,772
772,48,36,12,2018/12/6 14:25,2018/12/6 15:01,2018/12/6 15:12,773
773,42,28,14,2018/12/6 15:13,2018/12/6 15:41,2018/12/6 15:54,774
774,53,38,15,2018/12/6 15:55,2018/12/6 16:33,2018/12/6 16:47,775
775,48,33,15,2018/12/6 16:48,2018/12/6 17:21,2018/12/6 17:35,776
776,41,27,14,2018/12/6 17:36,2018/12/6 18:03,2018/12/6 18:16,777
777,59,44,15,2018/12/6 18:17,2018/12/6 19:01,2018/12/6 19:15,778
778,59,44,15,2018/12/6 19:16,2018/12/6 20:00,2018/12/6 20:14,779
779,42,38,4,2018/12/6 20:15,2018/12/6 20:53,2018/12/6 20:56,780
780,59,45,14,2018/12/6 20:57,2018/12/6 21:42,2018/12/6 21:55,781
781,39,25,14,2018/12/6 21:56,2018/12/6 22:21,2018/12/6 22:34,782
782,42,28,14,2018/12/6 22:35,2018/12/6 23:03,2018/12/6 23:16,783
783,55,41,14,2018/12/6 23:17,2018/12/6 23:58,2018/12/7 0:11,784
784,40,25,15,2018/12/7 0:12,2018/12/7 0:37,2018/12/7 0:51,785
785,54,40,14,2018/12/7 0:52,2018/12/7 1:32,2018/12/7 1:45,786
786,42,27,15,2018/12/7 1:46,2018/12/7 2:13,2018/12/7 2:27,787
787,48,33,15,2018/12/7 2:28,2018/12/7 3:01,2018/12/7 3:15,788
788,56,43,13,2018/12/7 3:16,2018/12/7 3:59,2018/12/7 4:11,789
789,54,40,14,2018/12/7 4:12,2018/12/7 4:52,2018/12/7 5:05,790
790,45,31,14,2018/12/7 5:06,2018/12/7 5:37,2018/12/7 5:50,791
791,42,28,14,2018/12/7 5:51,2018/12/7 6:19,2018/12/7 6:32,792
792,44,31,13,2018/12/7 6:33,2018/12/7 7:04,2018/12/7 7:16,793
793,37,26,11,2018/12/7 7:17,2018/12/7 7:43,2018/12/7 7:53,794
794,48,34,14,2018/12/7 7:54,2018/12/7 8:28,2018/12/7 8:41,795
795,46,30,16,2018/12/7 8:42,2018/12/7 9:12,2018/12/7 9:27,796
796,38,25,13,2018/12/7 9:28,2018/12/7 9:53,2018/12/7 10:05,797
797,38,25,13,2018/12/7 10:06,2018/12/7 10:31,2018/12/7 10:43,798
798,40,27,13,2018/12/7 10:44,2018/12/7 11:11,2018/12/7 11:23,799
799,46,33,13,2018/12/7 11:24,2018/12/7 11:57,2018/12/7 12:09,800
800,42,29,13,2018/12/7 12:10,2018/12/7 12:39,2018/12/7 12:51,801
801,51,37,14,2018/12/7 12:52,2018/12/7 13:29,2018/12/7 13:42,802
802,37,24,13,2018/12/7 13:43,2018/12/7 14:07,2018/12/7 14:19,803
803,34,24,10,2018/12/7 14:20,2018/12/7 14:44,2018/12/7 14:53,804
804,46,33,13,2018/12/7 14:54,2018/12/7 15:27,2018/12/7 15:39,805
805,31,23,8,2018/12/7 15:40,2018/12/7 16:03,2018/12/7 16:10,806
806,6,3,3,2018/12/7 16:11,2018/12/7 16:14,2018/12/7 16:16,807
807,38,27,11,2018/12/7 16:17,2018/12/7 16:44,2018/12/7 16:54,808
808,38,31,7,2018/12/7 16:55,2018/12/7 17:26,2018/12/7 17:32,809
809,60,50,10,2018/12/7 17:33,2018/12/7 18:23,2018/12/7 18:32,810
810,37,28,9,2018/12/7 18:33,2018/12/7 19:01,2018/12/7 19:09,811
811,5,3,2,2018/12/7 19:10,2018/12/7 19:13,2018/12/7 19:14,812
812,44,31,13,2018/12/7 19:15,2018/12/7 19:46,2018/12/7 19:58,813
813,30,25,5,2018/12/7 19:59,2018/12/7 20:24,2018/12/7 20:28,814
814,12,2,10,2018/12/7 20:29,2018/12/7 20:31,2018/12/7 20:40,815
815,42,28,14,2018/12/7 20:41,2018/12/7 21:09,2018/12/7 21:22,816
816,50,37,13,2018/12/7 21:23,2018/12/7 22:00,2018/12/7 22:12,817
817,55,41,14,2018/12/7 22:13,2018/12/7 22:54,2018/12/7 23:07,818
818,38,25,13,2018/12/7 23:08,2018/12/7 23:33,2018/12/7 23:45,819
819,40,27,13,2018/12/7 23:46,2018/12/8 0:13,2018/12/8 0:25,820
820,37,24,13,2018/12/8 0:26,2018/12/8 0:50,2018/12/8 1:02,821
821,38,26,12,2018/12/8 1:03,2018/12/8 1:29,2018/12/8 1:40,822
822,38,25,13,2018/12/8 1:41,2018/12/8 2:06,2018/12/8 2:18,823
823,38,26,12,2018/12/8 2:19,2018/12/8 2:45,2018/12/8 2:56,824
824,38,25,13,2018/12/8 2:57,2018/12/8 3:22,2018/12/8 3:34,825
825,39,26,13,2018/12/8 3:35,2018/12/8 4:01,2018/12/8 4:13,826
826,61,48,13,2018/12/8 4:14,2018/12/8 5:02,2018/12/8 5:14,827
827,43,30,13,2018/12/8 5:15,2018/12/8 5:45,2018/12/8 5:57,828
828,36,24,12,2018/12/8 5:58,2018/12/8 6:22,2018/12/8 6:33,829
829,34,22,12,2018/12/8 6:34,2018/12/8 6:56,2018/12/8 7:07,830
830,45,32,13,2018/12/8 7:08,2018/12/8 7:40,2018/12/8 7:52,831
831,39,25,14,2018/12/8 7:53,2018/12/8 8:18,2018/12/8 8:31,832
832,47,33,14,2018/12/8 8:32,2018/12/8 9:05,2018/12/8 9:18,833
833,42,29,13,2018/12/8 9:19,2018/12/8 9:48,2018/12/8 10:00,834
834,53,39,14,2018/12/8 10:01,2018/12/8 10:40,2018/12/8 10:53,835
835,42,30,12,2018/12/8 10:54,2018/12/8 11:24,2018/12/8 11:35,836
836,51,38,13,2018/12/8 11:36,2018/12/8 12:14,2018/12/8 12:26,837
837,38,24,14,2018/12/8 12:27,2018/12/8 12:51,2018/12/8 13:04,838
838,35,22,13,2018/12/8 13:05,2018/12/8 13:27,2018/12/8 13:39,839
839,65,51,14,2018/12/8 13:40,2018/12/8 14:31,2018/12/8 14:44,840
840,39,26,13,2018/12/8 14:45,2018/12/8 15:11,2018/12/8 15:23,841
841,38,24,14,2018/12/8 15:24,2018/12/8 15:48,2018/12/8 16:01,842
842,38,25,13,2018/12/8 16:02,2018/12/8 16:27,2018/12/8 16:39,843
843,40,26,14,2018/12/8 16:40,2018/12/8 17:06,2018/12/8 17:19,844
844,36,22,14,2018/12/8 17:20,2018/12/8 17:42,2018/12/8 17:55,845
845,37,23,14,2018/12/8 17:56,2018/12/8 18:19,2018/12/8 18:32,846
846,35,23,12,2018/12/8 18:33,2018/12/8 18:56,2018/12/8 19:07,847
847,48,35,13,2018/12/8 19:08,2018/12/8 19:43,2018/12/8 19:55,848
848,50,36,14,2018/12/8 19:56,2018/12/8 20:32,2018/12/8 20:45,849
849,48,36,12,2018/12/8 20:46,2018/12/8 21:22,2018/12/8 21:33,850
850,36,23,13,2018/12/8 21:34,2018/12/8 21:57,2018/12/8 22:09,851
851,35,22,13,2018/12/8 22:10,2018/12/8 22:32,2018/12/8 22:44,852
852,44,32,12,2018/12/8 22:45,2018/12/8 23:17,2018/12/8 23:28,853
853,38,27,11,2018/12/8 23:29,2018/12/8 23:56,2018/12/9 0:06,854
854,42,28,14,2018/12/9 0:07,2018/12/9 0:35,2018/12/9 0:48,855
855,35,23,12,2018/12/9 0:49,2018/12/9 1:12,2018/12/9 1:23,856
856,36,23,13,2018/12/9 1:24,2018/12/9 1:47,2018/12/9 1:59,857
857,48,36,12,2018/12/9 2:00,2018/12/9 2:36,2018/12/9 2:47,858
858,48,35,13,2018/12/9 2:48,2018/12/9 3:23,2018/12/9 3:35,859
859,58,45,13,2018/12/9 3:36,2018/12/9 4:21,2018/12/9 4:33,860
860,38,24,14,2018/12/9 4:34,2018/12/9 4:58,2018/12/9 5:11,861
861,37,23,14,2018/12/9 5:12,2018/12/9 5:35,2018/12/9 5:48,862
862,36,24,12,2018/12/9 5:49,2018/12/9 6:13,2018/12/9 6:24,863
863,38,24,14,2018/12/9 6:25,2018/12/9 6:49,2018/12/9 7:02,864
864,52,38,14,2018/12/9 7:03,2018/12/9 7:41,2018/12/9 7:54,865
865,47,32,15,2018/12/9 7:55,2018/12/9 8:27,2018/12/9 8:41,866
866,47,33,14,2018/12/9 8:42,2018/12/9 9:15,2018/12/9 9:28,867
867,40,26,14,2018/12/9 9:29,2018/12/9 9:55,2018/12/9 10:08,868
868,42,29,13,2018/12/9 10:09,2018/12/9 10:38,2018/12/9 10:50,869
869,37,23,14,2018/12/9 10:51,2018/12/9 11:14,2018/12/9 11:27,870
870,37,24,13,2018/12/9 11:28,2018/12/9 11:52,2018/12/9 12:04,871
871,39,26,13,2018/12/9 12:05,2018/12/9 12:31,2018/12/9 12:43,872
872,36,24,12,2018/12/9 12:44,2018/12/9 13:08,2018/12/9 13:19,873
873,47,34,13,2018/12/9 13:20,2018/12/9 13:54,2018/12/9 14:06,874
874,42,28,14,2018/12/9 14:07,2018/12/9 14:35,2018/12/9 14:48,875
875,37,25,12,2018/12/9 14:49,2018/12/9 15:14,2018/12/9 15:25,876
876,43,37,6,2018/12/9 15:26,2018/12/9 16:03,2018/12/9 16:08,877
877,15,9,6,2018/12/9 16:09,2018/12/9 16:18,2018/12/9 16:23,878
878,60,46,14,2018/12/9 16:24,2018/12/9 17:10,2018/12/9 17:23,879
879,37,24,13,2018/12/9 17:24,2018/12/9 17:48,2018/12/9 18:00,880
880,33,20,13,2018/12/9 18:01,2018/12/9 18:21,2018/12/9 18:33,881
881,38,24,14,2018/12/9 18:34,2018/12/9 18:58,2018/12/9 19:11,882
882,43,29,14,2018/12/9 19:12,2018/12/9 19:41,2018/12/9 19:54,883
883,41,28,13,2018/12/9 19:55,2018/12/9 20:23,2018/12/9 20:35,884
884,40,27,13,2018/12/9 20:36,2018/12/9 21:03,2018/12/9 21:15,885
885,35,22,13,2018/12/9 21:16,2018/12/9 21:38,2018/12/9 21:50,886
886,35,23,12,2018/12/9 21:51,2018/12/9 22:14,2018/12/9 22:25,887
887,36,22,14,2018/12/9 22:26,2018/12/9 22:48,2018/12/9 23:01,888
888,50,36,14,2018/12/9 23:02,2018/12/9 23:38,2018/12/9 23:51,889
889,42,29,13,2018/12/9 23:52,2018/12/10 0:21,2018/12/10 0:33,890
890,55,41,14,2018/12/10 0:34,2018/12/10 1:15,2018/12/10 1:28,891
891,35,21,14,2018/12/10 1:29,2018/12/10 1:50,2018/12/10 2:03,892
892,37,23,14,2018/12/10 2:04,2018/12/10 2:27,2018/12/10 2:40,893
893,36,24,12,2018/12/10 2:41,2018/12/10 3:05,2018/12/10 3:16,894
894,35,22,13,2018/12/10 3:17,2018/12/10 3:39,2018/12/10 3:51,895
895,36,23,13,2018/12/10 3:52,2018/12/10 4:15,2018/12/10 4:27,896
896,35,22,13,2018/12/10 4:28,2018/12/10 4:50,2018/12/10 5:02,897
897,34,21,13,2018/12/10 5:03,2018/12/10 5:24,2018/12/10 5:36,898
898,54,41,13,2018/12/10 5:37,2018/12/10 6:18,2018/12/10 6:30,899
899,105,91,14,2018/12/10 6:31,2018/12/10 8:02,2018/12/10 8:15,900
900,41,28,13,2018/12/10 8:16,2018/12/10 8:44,2018/12/10 8:56,901
901,37,25,12,2018/12/10 8:57,2018/12/10 9:22,2018/12/10 9:33,902
902,45,32,13,2018/12/10 9:34,2018/12/10 10:06,2018/12/10 10:18,903
903,41,28,13,2018/12/10 10:19,2018/12/10 10:47,2018/12/10 10:59,904
904,41,27,14,2018/12/10 11:00,2018/12/10 11:27,2018/12/10 11:40,905
905,48,35,13,2018/12/10 11:41,2018/12/10 12:16,2018/12/10 12:28,906
906,38,24,14,2018/12/10 12:29,2018/12/10 12:53,2018/12/10 13:06,907
907,40,28,12,2018/12/10 13:07,2018/12/10 13:35,2018/12/10 13:46,908
908,35,22,13,2018/12/10 13:47,2018/12/10 14:09,2018/12/10 14:21,909
909,46,32,14,2018/12/10 14:22,2018/12/10 14:54,2018/12/10 15:07,910
910,38,24,14,2018/12/10 15:08,2018/12/10 15:32,2018/12/10 15:45,911
911,69,56,13,2018/12/10 15:46,2018/12/10 16:42,2018/12/10 16:54,912
912,38,26,12,2018/12/10 16:55,2018/12/10 17:21,2018/12/10 17:32,913
913,35,23,12,2018/12/10 17:33,2018/12/10 17:56,2018/12/10 18:07,914
914,34,21,13,2018/12/10 18:08,2018/12/10 18:29,2018/12/10 18:41,915
915,34,22,12,2018/12/10 18:42,2018/12/10 19:04,2018/12/10 19:15,916
916,41,27,14,2018/12/10 19:16,2018/12/10 19:43,2018/12/10 19:56,917
917,43,28,15,2018/12/10 19:57,2018/12/10 20:25,2018/12/10 20:39,918
918,39,25,14,2018/12/10 20:40,2018/12/10 21:05,2018/12/10 21:18,919
919,44,30,14,2018/12/10 21:19,2018/12/10 21:49,2018/12/10 22:02,920
920,38,25,13,2018/12/10 22:03,2018/12/10 22:28,2018/12/10 22:40,921
921,39,26,13,2018/12/10 22:41,2018/12/10 23:07,2018/12/10 23:19,922
922,40,27,13,2018/12/10 23:20,2018/12/10 23:47,2018/12/10 23:59,923
923,37,24,13,2018/12/11 0:00,2018/12/11 0:24,2018/12/11 0:36,924
924,39,25,14,2018/12/11 0:37,2018/12/11 1:02,2018/12/11 1:15,925
925,51,38,13,2018/12/11 1:16,2018/12/11 1:54,2018/12/11 2:06,926
926,40,27,13,2018/12/11 2:07,2018/12/11 2:34,2018/12/11 2:46,927
927,46,32,14,2018/12/11 2:47,2018/12/11 3:19,2018/12/11 3:32,928
928,34,21,13,2018/12/11 3:33,2018/12/11 3:54,2018/12/11 4:06,929
929,39,26,13,2018/12/11 4:07,2018/12/11 4:33,2018/12/11 4:45,930
930,37,24,13,2018/12/11 4:46,2018/12/11 5:10,2018/12/11 5:22,931
931,35,23,12,2018/12/11 5:23,2018/12/11 5:46,2018/12/11 5:57,932
932,36,22,14,2018/12/11 5:58,2018/12/11 6:20,2018/12/11 6:33,933
933,38,24,14,2018/12/11 6:34,2018/12/11 6:58,2018/12/11 7:11,934
934,42,27,15,2018/12/11 7:12,2018/12/11 7:39,2018/12/11 7:53,935
935,30,24,6,2018/12/11 7:54,2018/12/11 8:18,2018/12/11 8:23,936
936,14,6,8,2018/12/11 8:24,2018/12/11 8:30,2018/12/11 8:37,937
937,113,98,15,2018/12/11 8:38,2018/12/11 10:16,2018/12/11 10:30,938
938,40,26,14,2018/12/11 10:31,2018/12/11 10:57,2018/12/11 11:10,939
939,40,27,13,2018/12/11 11:11,2018/12/11 11:38,2018/12/11 11:50,940
940,48,34,14,2018/12/11 11:51,2018/12/11 12:25,2018/12/11 12:38,941
941,49,35,14,2018/12/11 12:39,2018/12/11 13:14,2018/12/11 13:27,942
942,40,26,14,2018/12/11 13:28,2018/12/11 13:54,2018/12/11 14:07,943
943,40,26,14,2018/12/11 14:08,2018/12/11 14:34,2018/12/11 14:47,944
944,41,27,14,2018/12/11 14:48,2018/12/11 15:15,2018/12/11 15:28,945
945,40,26,14,2018/12/11 15:29,2018/12/11 15:55,2018/12/11 16:08,946
946,40,26,14,2018/12/11 16:09,2018/12/11 16:35,2018/12/11 16:48,947
947,39,25,14,2018/12/11 16:49,2018/12/11 17:14,2018/12/11 17:27,948
948,56,44,12,2018/12/11 17:28,2018/12/11 18:12,2018/12/11 18:23,949
949,4,3,1,2018/12/11 18:24,2018/12/11 18:27,2018/12/11 18:27,950
950,45,31,14,2018/12/11 18:28,2018/12/11 18:59,2018/12/11 19:12,951
951,40,26,14,2018/12/11 19:13,2018/12/11 19:39,2018/12/11 19:52,952
952,39,26,13,2018/12/11 19:53,2018/12/11 20:19,2018/12/11 20:31,953
953,39,27,12,2018/12/11 20:32,2018/12/11 20:59,2018/12/11 21:10,954
954,43,31,12,2018/12/11 21:11,2018/12/11 21:42,2018/12/11 21:53,955
955,38,25,13,2018/12/11 21:54,2018/12/11 22:19,2018/12/11 22:31,956
956,48,37,11,2018/12/11 22:32,2018/12/11 23:09,2018/12/11 23:19,957
957,41,29,12,2018/12/11 23:20,2018/12/11 23:49,2018/12/12 0:00,958
958,36,25,11,2018/12/12 0:01,2018/12/12 0:26,2018/12/12 0:36,959
959,37,28,9,2018/12/12 0:37,2018/12/12 1:05,2018/12/12 1:13,960
960,45,33,12,2018/12/12 1:14,2018/12/12 1:47,2018/12/12 1:58,961
961,54,43,11,2018/12/12 1:59,2018/12/12 2:42,2018/12/12 2:52,962
962,3,2,1,2018/12/12 2:53,2018/12/12 2:55,2018/12/12 2:55,963
963,40,27,13,2018/12/12 2:56,2018/12/12 3:23,2018/12/12 3:35,964
964,34,22,12,2018/12/12 3:36,2018/12/12 3:58,2018/12/12 4:09,965
965,36,23,13,2018/12/12 4:10,2018/12/12 4:33,2018/12/12 4:45,966
966,36,24,12,2018/12/12 4:46,2018/12/12 5:10,2018/12/12 5:21,967
967,36,23,13,2018/12/12 5:22,2018/12/12 5:45,2018/12/12 5:57,968
968,36,23,13,2018/12/12 5:58,2018/12/12 6:21,2018/12/12 6:33,969
969,39,25,14,2018/12/12 6:34,2018/12/12 6:59,2018/12/12 7:12,970
970,42,29,13,2018/12/12 7:13,2018/12/12 7:42,2018/12/12 7:54,971
971,49,35,14,2018/12/12 7:55,2018/12/12 8:30,2018/12/12 8:43,972
972,38,25,13,2018/12/12 8:44,2018/12/12 9:09,2018/12/12 9:21,973
973,42,29,13,2018/12/12 9:22,2018/12/12 9:51,2018/12/12 10:03,974
974,43,30,13,2018/12/12 10:04,2018/12/12 10:34,2018/12/12 10:46,975
975,40,27,13,2018/12/12 10:47,2018/12/12 11:14,2018/12/12 11:26,976
976,49,37,12,2018/12/12 11:27,2018/12/12 12:04,2018/12/12 12:15,977
977,42,29,13,2018/12/12 12:16,2018/12/12 12:45,2018/12/12 12:57,978
978,41,29,12,2018/12/12 12:58,2018/12/12 13:27,2018/12/12 13:38,979
979,39,26,13,2018/12/12 13:39,2018/12/12 14:05,2018/12/12 14:17,980
980,38,26,12,2018/12/12 14:18,2018/12/12 14:44,2018/12/12 14:55,981
981,38,26,12,2018/12/12 14:56,2018/12/12 15:22,2018/12/12 15:33,982
982,46,33,13,2018/12/12 15:34,2018/12/12 16:07,2018/12/12 16:19,983
983,39,26,13,2018/12/12 16:20,2018/12/12 16:46,2018/12/12 16:58,984
984,41,28,13,2018/12/12 16:59,2018/12/12 17:27,2018/12/12 17:39,985
985,39,26,13,2018/12/12 17:40,2018/12/12 18:06,2018/12/12 18:18,986
986,39,26,13,2018/12/12 18:19,2018/12/12 18:45,2018/12/12 18:57,987
987,43,30,13,2018/12/12 18:58,2018/12/12 19:28,2018/12/12 19:40,988
988,77,62,15,2018/12/12 19:41,2018/12/12 20:43,2018/12/12 20:57,989
989,64,51,13,2018/12/12 20:58,2018/12/12 21:49,2018/12/12 22:01,990
990,59,46,13,2018/12/12 22:02,2018/12/12 22:48,2018/12/12 23:00,991
991,46,33,13,2018/12/12 23:01,2018/12/12 23:34,2018/12/12 23:46,992
992,110,96,14,2018/12/12 23:47,2018/12/13 1:23,2018/12/13 1:36,993
993,49,36,13,2018/12/13 1:37,2018/12/13 2:13,2018/12/13 2:25,994
994,82,68,14,2018/12/13 2:26,2018/12/13 3:34,2018/12/13 3:47,995
995,34,25,9,2018/12/13 3:48,2018/12/13 4:13,2018/12/13 4:21,996
996,7,1,6,2018/12/13 4:22,2018/12/13 4:23,2018/12/13 4:28,997
997,49,36,13,2018/12/13 4:29,2018/12/13 5:05,2018/12/13 5:17,998
998,47,33,14,2018/12/13 5:18,2018/12/13 5:51,2018/12/13 6:04,999
999,93,80,13,2018/12/13 6:05,2018/12/13 7:25,2018/12/13 7:37,1000
1000,59,47,12,2018/12/13 7:38,2018/12/13 8:25,2018/12/13 8:36,1001
1001,59,45,14,2018/12/13 8:37,2018/12/13 9:22,2018/12/13 9:35,1002
1002,56,43,13,2018/12/13 9:36,2018/12/13 10:19,2018/12/13 10:31,1003
1003,51,37,14,2018/12/13 10:32,2018/12/13 11:09,2018/12/13 11:22,1004
1004,51,38,13,2018/12/13 11:23,2018/12/13 12:01,2018/12/13 12:13,1005
1005,51,38,13,2018/12/13 12:14,2018/12/13 12:52,2018/12/13 13:04,1006
1006,53,38,15,2018/12/13 13:05,2018/12/13 13:43,2018/12/13 13:57,1007
1007,114,98,16,2018/12/13 13:58,2018/12/13 15:36,2018/12/13 15:51,1008
1008,45,31,14,2018/12/13 15:52,2018/12/13 16:23,2018/12/13 16:36,1009
1009,53,39,14,2018/12/13 16:37,2018/12/13 17:16,2018/12/13 17:29,1010
1010,78,63,15,2018/12/13 17:30,2018/12/13 18:33,2018/12/13 18:47,1011
1011,55,40,15,2018/12/13 18:48,2018/12/13 19:28,2018/12/13 19:42,1012
1012,45,32,13,2018/12/13 19:43,2018/12/13 20:15,2018/12/13 20:27,1013
1013,57,42,15,2018/12/13 20:28,2018/12/13 21:10,2018/12/13 21:24,1014
1014,73,58,15,2018/12/13 21:25,2018/12/13 22:23,2018/12/13 22:37,1015
1015,76,62,14,2018/12/13 22:38,2018/12/13 23:40,2018/12/13 23:53,1016
1016,44,30,14,2018/12/13 23:54,2018/12/14 0:24,2018/12/14 0:37,1017
1017,57,43,14,2018/12/14 0:38,2018/12/14 1:21,2018/12/14 1:34,1018
1018,43,30,13,2018/12/14 1:35,2018/12/14 2:05,2018/12/14 2:17,1019
1019,68,54,14,2018/12/14 2:18,2018/12/14 3:12,2018/12/14 3:25,1020
1020,52,38,14,2018/12/14 3:26,2018/12/14 4:04,2018/12/14 4:17,1021
1021,74,60,14,2018/12/14 4:18,2018/12/14 5:18,2018/12/14 5:31,1022
1022,42,28,14,2018/12/14 5:32,2018/12/14 6:00,2018/12/14 6:13,1023
1023,83,67,16,2018/12/14 6:14,2018/12/14 7:21,2018/12/14 7:36,1024
1024,94,81,13,2018/12/14 7:37,2018/12/14 8:58,2018/12/14 9:10,1025
1025,50,35,15,2018/12/14 9:11,2018/12/14 9:46,2018/12/14 10:00,1026
1026,33,30,3,2018/12/14 10:01,2018/12/14 10:31,2018/12/14 10:33,1027
1027,13,1,12,2018/12/14 10:34,2018/12/14 10:35,2018/12/14 10:46,1028
1028,46,31,15,2018/12/14 10:47,2018/12/14 11:18,2018/12/14 11:32,1029
1029,57,43,14,2018/12/14 11:33,2018/12/14 12:16,2018/12/14 12:29,1030
1030,55,41,14,2018/12/14 12:30,2018/12/14 13:11,2018/12/14 13:24,1031
1031,53,40,13,2018/12/14 13:25,2018/12/14 14:05,2018/12/14 14:17,1032
1032,46,33,13,2018/12/14 14:18,2018/12/14 14:51,2018/12/14 15:03,1033
1033,45,32,13,2018/12/14 15:04,2018/12/14 15:36,2018/12/14 15:48,1034
1034,43,31,12,2018/12/14 15:49,2018/12/14 16:20,2018/12/14 16:31,1035
1035,42,27,15,2018/12/14 16:32,2018/12/14 16:59,2018/12/14 17:13,1036
1036,41,28,13,2018/12/14 17:14,2018/12/14 17:42,2018/12/14 17:54,1037
1037,66,52,14,2018/12/14 17:55,2018/12/14 18:47,2018/12/14 19:00,1038
1038,45,30,15,2018/12/14 19:01,2018/12/14 19:31,2018/12/14 19:45,1039
1039,43,28,15,2018/12/14 19:46,2018/12/14 20:14,2018/12/14 20:28,1040
1040,50,35,15,2018/12/14 20:29,2018/12/14 21:04,2018/12/14 21:18,1041
1041,53,40,13,2018/12/14 21:19,2018/12/14 21:59,2018/12/14 22:11,1042
1042,42,28,14,2018/12/14 22:12,2018/12/14 22:40,2018/12/14 22:53,1043
1043,45,29,16,2018/12/14 22:54,2018/12/14 23:23,2018/12/14 23:38,1044
1044,50,34,16,2018/12/14 23:39,2018/12/15 0:13,2018/12/15 0:28,1045
1045,51,35,16,2018/12/15 0:29,2018/12/15 1:04,2018/12/15 1:19,1046
1046,72,57,15,2018/12/15 1:20,2018/12/15 2:17,2018/12/15 2:31,1047
1047,42,26,16,2018/12/15 2:32,2018/12/15 2:58,2018/12/15 3:13,1048
1048,71,55,16,2018/12/15 3:14,2018/12/15 4:09,2018/12/15 4:24,1049
1049,78,63,15,2018/12/15 4:25,2018/12/15 5:28,2018/12/15 5:42,1050
1050,56,43,13,2018/12/15 5:43,2018/12/15 6:26,2018/12/15 6:38,1051
1051,38,25,13,2018/12/15 6:39,2018/12/15 7:04,2018/12/15 7:16,1052
1052,37,28,9,2018/12/15 7:17,2018/12/15 7:45,2018/12/15 7:53,1053
1053,68,53,15,2018/12/15 7:54,2018/12/15 8:47,2018/12/15 9:01,1054
1054,75,60,15,2018/12/15 9:02,2018/12/15 10:02,2018/12/15 10:16,1055
1055,45,30,15,2018/12/15 10:17,2018/12/15 10:47,2018/12/15 11:01,1056
1056,52,36,16,2018/12/15 11:02,2018/12/15 11:38,2018/12/15 11:53,1057
1057,48,33,15,2018/12/15 11:54,2018/12/15 12:27,2018/12/15 12:41,1058
1058,48,33,15,2018/12/15 12:42,2018/12/15 13:15,2018/12/15 13:29,1059
1059,46,33,13,2018/12/15 13:30,2018/12/15 14:03,2018/12/15 14:15,1060
1060,58,42,16,2018/12/15 14:16,2018/12/15 14:58,2018/12/15 15:13,1061
1061,92,76,16,2018/12/15 15:14,2018/12/15 16:30,2018/12/15 16:45,1062
1062,46,31,15,2018/12/15 16:46,2018/12/15 17:17,2018/12/15 17:31,1063
1063,52,38,14,2018/12/15 17:32,2018/12/15 18:10,2018/12/15 18:23,1064
1064,66,50,16,2018/12/15 18:24,2018/12/15 19:14,2018/12/15 19:29,1065
1065,66,52,14,2018/12/15 19:30,2018/12/15 20:22,2018/12/15 20:35,1066
1066,56,41,15,2018/12/15 20:36,2018/12/15 21:17,2018/12/15 21:31,1067
1067,72,57,15,2018/12/15 21:32,2018/12/15 22:29,2018/12/15 22:43,1068
1068,39,30,9,2018/12/15 22:44,2018/12/15 23:14,2018/12/15 23:22,1069
1069,13,9,4,2018/12/15 23:23,2018/12/15 23:32,2018/12/15 23:35,1070
1070,49,35,14,2018/12/15 23:36,2018/12/16 0:11,2018/12/16 0:24,1071
1071,62,47,15,2018/12/16 0:25,2018/12/16 1:12,2018/12/16 1:26,1072
1072,62,47,15,2018/12/16 1:27,2018/12/16 2:14,2018/12/16 2:28,1073
1073,45,31,14,2018/12/16 2:29,2018/12/16 3:00,2018/12/16 3:13,1074
1074,47,34,13,2018/12/16 3:14,2018/12/16 3:48,2018/12/16 4:00,1075
1075,107,105,2,2018/12/16 4:01,2018/12/16 5:46,2018/12/16 5:47,1076
1076,13,1,12,2018/12/16 5:48,2018/12/16 5:49,2018/12/16 6:00,1077
1077,74,61,13,2018/12/16 6:01,2018/12/16 7:02,2018/12/16 7:14,1078
1078,69,54,15,2018/12/16 7:15,2018/12/16 8:09,2018/12/16 8:23,1079
1079,48,35,13,2018/12/16 8:24,2018/12/16 8:59,2018/12/16 9:11,1080
1080,54,41,13,2018/12/16 9:12,2018/12/16 9:53,2018/12/16 10:05,1081
1081,53,41,12,2018/12/16 10:06,2018/12/16 10:47,2018/12/16 10:58,1082
1082,139,127,12,2018/12/16 10:59,2018/12/16 13:06,2018/12/16 13:17,1083
1083,88,75,13,2018/12/16 13:18,2018/12/16 14:33,2018/12/16 14:45,1084
1084,50,37,13,2018/12/16 14:46,2018/12/16 15:23,2018/12/16 15:35,1085
1085,47,32,15,2018/12/16 15:36,2018/12/16 16:08,2018/12/16 16:22,1086
1086,50,36,14,2018/12/16 16:23,2018/12/16 16:59,2018/12/16 17:12,1087
1087,56,43,13,2018/12/16 17:13,2018/12/16 17:56,2018/12/16 18:08,1088
1088,71,56,15,2018/12/16 18:09,2018/12/16 19:05,2018/12/16 19:19,1089
1089,88,73,15,2018/12/16 19:20,2018/12/16 20:33,2018/12/16 20:47,1090
1090,58,42,16,2018/12/16 20:48,2018/12/16 21:30,2018/12/16 21:45,1091
1091,46,31,15,2018/12/16 21:46,2018/12/16 22:17,2018/12/16 22:31,1092
1092,51,37,14,2018/12/16 22:32,2018/12/16 23:09,2018/12/16 23:22,1093
1093,48,34,14,2018/12/16 23:23,2018/12/16 23:57,2018/12/17 0:10,1094
1094,59,45,14,2018/12/17 0:11,2018/12/17 0:56,2018/12/17 1:09,1095
1095,88,72,16,2018/12/17 1:10,2018/12/17 2:22,2018/12/17 2:37,1096
1096,58,46,12,2018/12/17 2:38,2018/12/17 3:24,2018/12/17 3:35,1097
1097,46,32,14,2018/12/17 3:36,2018/12/17 4:08,2018/12/17 4:21,1098
1098,64,50,14,2018/12/17 4:22,2018/12/17 5:12,2018/12/17 5:25,1099
1099,119,115,4,2018/12/17 5:26,2018/12/17 7:21,2018/12/17 7:24,1100
1100,14,5,9,2018/12/17 7:25,2018/12/17 7:30,2018/12/17 7:38,1101
1101,39,37,2,2018/12/17 7:39,2018/12/17 8:16,2018/12/17 8:17,1102
1102,19,7,12,2018/12/17 8:18,2018/12/17 8:25,2018/12/17 8:36,1103
1103,45,31,14,2018/12/17 8:37,2018/12/17 9:08,2018/12/17 9:21,1104
1104,50,37,13,2018/12/17 9:22,2018/12/17 9:59,2018/12/17 10:11,1105
1105,2,1,1,2018/12/17 10:12,2018/12/17 10:13,2018/12/17 10:13,1106
1106,60,43,17,2018/12/17 10:14,2018/12/17 10:57,2018/12/17 11:13,1107
1107,326,314,12,2018/12/17 11:14,2018/12/17 16:28,2018/12/17 16:39,1108
1108,42,37,5,2018/12/17 16:40,2018/12/17 17:17,2018/12/17 17:21,1109
1109,13,4,9,2018/12/17 17:22,2018/12/17 17:26,2018/12/17 17:34,1110
1110,72,66,6,2018/12/17 17:35,2018/12/17 18:41,2018/12/17 18:46,1111
1111,10,1,9,2018/12/17 18:47,2018/12/17 18:48,2018/12/17 18:56,1112
1112,58,42,16,2018/12/17 18:57,2018/12/17 19:39,2018/12/17 19:54,1113
1113,113,98,15,2018/12/17 19:55,2018/12/17 21:33,2018/12/17 21:47,1114
1114,61,48,13,2018/12/17 21:48,2018/12/17 22:36,2018/12/17 22:48,1115
1115,51,37,14,2018/12/17 22:49,2018/12/17 23:26,2018/12/17 23:39,1116
1116,49,34,15,2018/12/17 23:40,2018/12/18 0:14,2018/12/18 0:28,1117
1117,49,37,12,2018/12/18 0:29,2018/12/18 1:06,2018/12/18 1:17,1118
1118,57,46,11,2018/12/18 1:18,2018/12/18 2:04,2018/12/18 2:14,1119
1119,58,44,14,2018/12/18 2:15,2018/12/18 2:59,2018/12/18 3:12,1120
1120,96,82,14,2018/12/18 3:13,2018/12/18 4:35,2018/12/18 4:48,1121
1121,53,41,12,2018/12/18 4:49,2018/12/18 5:30,2018/12/18 5:41,1122
1122,70,55,15,2018/12/18 5:42,2018/12/18 6:37,2018/12/18 6:51,1123
1123,60,47,13,2018/12/18 6:52,2018/12/18 7:39,2018/12/18 7:51,1124
1124,60,46,14,2018/12/18 7:52,2018/12/18 8:38,2018/12/18 8:51,1125
1125,101,85,16,2018/12/18 8:52,2018/12/18 10:17,2018/12/18 10:32,1126
1126,57,42,15,2018/12/18 10:33,2018/12/18 11:15,2018/12/18 11:29,1127
1127,46,45,1,2018/12/18 11:30,2018/12/18 12:15,2018/12/18 12:15,1128
1128,13,1,12,2018/12/18 12:16,2018/12/18 12:17,2018/12/18 12:28,1129
1129,67,53,14,2018/12/18 12:29,2018/12/18 13:22,2018/12/18 13:35,1130
1130,68,54,14,2018/12/18 13:36,2018/12/18 14:30,2018/12/18 14:43,1131
1131,56,41,15,2018/12/18 14:44,2018/12/18 15:25,2018/12/18 15:39,1132
1132,63,47,16,2018/12/18 15:40,2018/12/18 16:27,2018/12/18 16:42,1133
1133,52,38,14,2018/12/18 16:43,2018/12/18 17:21,2018/12/18 17:34,1134
1134,55,41,14,2018/12/18 17:35,2018/12/18 18:16,2018/12/18 18:29,1135
1135,87,74,13,2018/12/18 18:30,2018/12/18 19:44,2018/12/18 19:56,1136
1136,84,68,16,2018/12/18 19:57,2018/12/18 21:05,2018/12/18 21:20,1137
1137,56,43,13,2018/12/18 21:21,2018/12/18 22:04,2018/12/18 22:16,1138
1138,93,78,15,2018/12/18 22:17,2018/12/18 23:35,2018/12/18 23:49,1139
1139,101,87,14,2018/12/18 23:50,2018/12/19 1:17,2018/12/19 1:30,1140
1140,35,34,1,2018/12/19 1:31,2018/12/19 2:05,2018/12/19 2:05,1141
1141,15,1,14,2018/12/19 2:06,2018/12/19 2:07,2018/12/19 2:20,1142
1142,2,1,1,2018/12/19 2:21,2018/12/19 2:22,2018/12/19 2:22,1143
1143,59,42,17,2018/12/19 2:23,2018/12/19 3:05,2018/12/19 3:21,1144
1144,50,34,16,2018/12/19 3:22,2018/12/19 3:56,2018/12/19 4:11,1145
1145,119,104,15,2018/12/19 4:12,2018/12/19 5:56,2018/12/19 6:10,1146
1146,51,35,16,2018/12/19 6:11,2018/12/19 6:46,2018/12/19 7:01,1147
1147,36,35,1,2018/12/19 7:02,2018/12/19 7:37,2018/12/19 7:37,1148
1148,18,5,13,2018/12/19 7:38,2018/12/19 7:43,2018/12/19 7:55,1149
1149,79,63,16,2018/12/19 7:56,2018/12/19 8:59,2018/12/19 9:14,1150
1150,468,455,13,2018/12/19 9:15,2018/12/19 16:50,2018/12/19 17:02,1151
1151,65,54,11,2018/12/19 17:03,2018/12/19 17:57,2018/12/19 18:07,1152
1152,91,78,13,2018/12/19 18:08,2018/12/19 19:26,2018/12/19 19:38,1153
1153,55,41,14,2018/12/19 19:39,2018/12/19 20:20,2018/12/19 20:33,1154
1154,55,42,13,2018/12/19 20:34,2018/12/19 21:16,2018/12/19 21:28,1155
1155,61,48,13,2018/12/19 21:29,2018/12/19 22:17,2018/12/19 22:29,1156
1156,59,45,14,2018/12/19 22:30,2018/12/19 23:15,2018/12/19 23:28,1157
1157,58,45,13,2018/12/19 23:29,2018/12/20 0:14,2018/12/20 0:26,1158
1158,57,44,13,2018/12/20 0:27,2018/12/20 1:11,2018/12/20 1:23,1159
1159,48,33,15,2018/12/20 1:24,2018/12/20 1:57,2018/12/20 2:11,1160
1160,58,43,15,2018/12/20 2:12,2018/12/20 2:55,2018/12/20 3:09,1161
1161,66,55,11,2018/12/20 3:10,2018/12/20 4:05,2018/12/20 4:15,1162
1162,70,68,2,2018/12/20 4:16,2018/12/20 5:24,2018/12/20 5:25,1163
1163,14,2,12,2018/12/20 5:26,2018/12/20 5:28,2018/12/20 5:39,1164
1164,54,37,17,2018/12/20 5:40,2018/12/20 6:17,2018/12/20 6:33,1165
1165,37,35,2,2018/12/20 6:34,2018/12/20 7:09,2018/12/20 7:10,1166
1166,14,4,10,2018/12/20 7:11,2018/12/20 7:15,2018/12/20 7:24,1167
1167,49,48,1,2018/12/20 7:25,2018/12/20 8:13,2018/12/20 8:13,1168
1168,34,21,13,2018/12/20 8:14,2018/12/20 8:35,2018/12/20 8:47,1169
1169,77,63,14,2018/12/20 8:48,2018/12/20 9:51,2018/12/20 10:04,1170
1170,48,33,15,2018/12/20 10:05,2018/12/20 10:38,2018/12/20 10:52,1171
1171,51,36,15,2018/12/20 10:53,2018/12/20 11:29,2018/12/20 11:43,1172
1172,59,44,15,2018/12/20 11:44,2018/12/20 12:28,2018/12/20 12:42,1173
1173,58,43,15,2018/12/20 12:43,2018/12/20 13:26,2018/12/20 13:40,1174
1174,41,29,12,2018/12/20 13:41,2018/12/20 14:10,2018/12/20 14:21,1175
1175,6,3,3,2018/12/20 14:22,2018/12/20 14:25,2018/12/20 14:27,1176
1176,42,41,1,2018/12/20 14:28,2018/12/20 15:09,2018/12/20 15:09,1177
1177,19,7,12,2018/12/20 15:10,2018/12/20 15:17,2018/12/20 15:28,1178
1178,95,82,13,2018/12/20 15:29,2018/12/20 16:51,2018/12/20 17:03,1179
1179,54,41,13,2018/12/20 17:04,2018/12/20 17:45,2018/12/20 17:57,1180
1180,46,36,10,2018/12/20 17:58,2018/12/20 18:34,2018/12/20 18:43,1181
1181,7,4,3,2018/12/20 18:44,2018/12/20 18:48,2018/12/20 18:50,1182
1182,108,95,13,2018/12/20 18:51,2018/12/20 20:26,2018/12/20 20:38,1183
1183,49,38,11,2018/12/20 20:39,2018/12/20 21:17,2018/12/20 21:27,1184
1184,57,42,15,2018/12/20 21:28,2018/12/20 22:10,2018/12/20 22:24,1185
1185,46,31,15,2018/12/20 22:25,2018/12/20 22:56,2018/12/20 23:10,1186
